Rk,Player,Nation,Pos,Squad,Age,Born,90s,Tkl,TklW,Def 3rd,Mid 3rd,Att 3rd,Tkl,Att,Tkl%,Lost,Blocks,Sh,Pass,Int,Tkl+Int,Clr,Err,Matches,Année édition
1,Liel Abada,il ISR,"FW,MF",Celtic,20,2001,2.4,1,1,0,0,1,0,2,0.0,2,0,0,0,2,3,1,0,Matches,2023
2,Oliver Abildgaard,dk DEN,MF,Celtic,26,1996,0.7,4,3,3,1,0,2,4,50.0,2,1,0,1,0,4,1,0,Matches,2023
3,Mohammad Abu Fani,il ISR,MF,Maccabi Haifa,24,1998,4.4,9,6,6,1,2,3,8,37.5,5,7,2,5,3,12,0,0,Matches,2023
4,Francesco Acerbi,it ITA,DF,Inter,34,1988,10.2,10,8,8,2,0,4,7,57.1,3,8,2,6,11,21,46,0,Matches,2023
5,Marcos Acuña,ar ARG,"DF,MF",Sevilla,30,1991,2.4,9,5,7,2,0,8,9,88.9,1,0,0,0,2,11,3,0,Matches,2023
6,Junior Adamu,at AUT,FW,RB Salzburg,21,2001,2.3,9,8,4,2,3,1,3,33.3,2,5,1,4,1,10,0,0,Matches,2023
7,Antonio Adán,es ESP,GK,Sporting CP,35,1987,4.2,0,0,0,0,0,0,0,,0,0,0,0,0,0,4,1,Matches,2023
8,Arijan Ademi,mk MKD,MF,Dinamo Zagreb,31,1991,5.2,16,11,10,6,0,7,13,53.8,6,5,3,2,3,19,3,0,Matches,2023
9,Karim Adeyemi,de GER,"FW,MF",Dortmund,20,2002,4.2,1,1,0,0,1,1,3,33.3,2,3,0,3,2,3,1,0,Matches,2023
10,Amine Adli,ma MAR,"FW,MF",Leverkusen,22,2000,1.3,3,1,1,2,0,0,1,0.0,1,6,0,6,0,3,0,0,Matches,2023
11,Manuel Akanji,ch SUI,DF,Manchester City,27,1995,10.5,27,16,10,15,2,14,26,53.8,12,14,2,12,9,36,20,1,Matches,2023
12,Nathan Aké,nl NED,DF,Manchester City,27,1995,6.8,12,6,3,6,3,3,5,60.0,2,2,1,1,7,19,13,0,Matches,2023
13,David Alaba,at AUT,DF,Real Madrid,30,1992,7.9,8,3,2,5,1,5,12,41.7,7,12,8,4,7,15,12,0,Matches,2023
14,Lucas Alario,ar ARG,"FW,MF",Eint Frankfurt,29,1992,0.2,0,0,0,0,0,0,0,,0,0,0,0,0,0,0,0,Matches,2023
15,Jordi Alba,es ESP,DF,Barcelona,33,1989,1.6,0,0,0,0,0,0,1,0.0,1,3,2,1,0,0,1,0,Matches,2023
16,Thiago Alcántara,es ESP,MF,Liverpool,31,1991,3.4,15,8,5,6,4,5,9,55.6,4,4,0,4,7,22,0,0,Matches,2023
17,Trent Alexander-Arnold,eng ENG,DF,Liverpool,23,1998,6.9,19,13,10,8,1,16,30,53.3,14,7,2,5,4,23,3,0,Matches,2023
18,Sotiris Alexandropoulos,gr GRE,MF,Sporting CP,20,2001,1.3,1,1,0,1,0,0,0,,0,2,2,0,0,1,2,0,Matches,2023
19,Faride Alidou,de GER,"DF,FW",Eint Frankfurt,21,2001,0.8,4,4,2,2,0,2,3,66.7,1,5,0,5,1,5,0,0,Matches,2023
20,Alisson,br BRA,GK,Liverpool,29,1992,8.0,0,0,0,0,0,0,2,0.0,2,0,0,0,0,0,1,1,Matches,2023
21,Marcos Alonso,es ESP,DF,Barcelona,31,1990,4.5,5,2,3,1,1,3,6,50.0,3,7,4,3,6,11,18,0,Matches,2023
22,Éder Álvarez Balanta,co COL,"MF,FW",Club Brugge,29,1993,0.6,0,0,0,0,0,0,0,,0,1,1,0,2,2,1,0,Matches,2023
23,Edson Álvarez,mx MEX,MF,Ajax,24,1997,5.9,15,8,6,8,1,8,12,66.7,4,5,1,4,11,26,18,0,Matches,2023
24,Julián Álvarez,ar ARG,FW,Manchester City,22,2000,5.3,5,3,0,2,3,0,5,0.0,5,1,0,1,2,7,1,0,Matches,2023
25,Nadiem Amiri,de GER,"MF,FW",Leverkusen,25,1996,1.4,3,2,1,0,2,2,4,50.0,2,0,0,0,2,5,1,0,Matches,2023
26,Robert Andrich,de GER,MF,Leverkusen,27,1994,4.5,10,7,3,6,1,5,6,83.3,1,13,7,6,5,15,10,0,Matches,2023
27,Peter Ankersen,dk DEN,DF,FC Copenhagen,31,1990,0.3,0,0,0,0,0,0,0,,0,0,0,0,0,0,0,0,Matches,2023
28,Ofri Arad,il ISR,"DF,MF",Maccabi Haifa,23,1998,0.2,2,2,1,0,1,1,1,100.0,0,1,0,1,1,3,0,0,Matches,2023
29,Charles Aránguiz,cl CHI,MF,Leverkusen,33,1989,2.4,4,2,1,1,2,1,2,50.0,1,3,2,1,2,6,3,0,Matches,2023
30,Henrique Araújo,pt POR,FW,Benfica,20,2002,0.1,0,0,0,0,0,0,0,,0,0,0,0,0,0,0,0,Matches,2023
31,Ronald Araújo,uy URU,DF,Barcelona,23,1999,1.0,1,0,1,0,0,0,0,,0,2,1,1,0,1,0,0,Matches,2023
32,Scott Arfield,ca CAN,MF,Rangers,33,1988,3.0,4,1,0,4,0,1,6,16.7,5,4,1,3,1,5,1,0,Matches,2023
33,Hákon Arnar Haraldsson,is ISL,FW,FC Copenhagen,19,2003,3.3,5,3,2,2,1,1,2,50.0,1,1,0,1,0,5,1,0,Matches,2023
34,Kepa Arrizabalaga,es ESP,GK,Chelsea,27,1994,9.0,0,0,0,0,0,0,1,0.0,1,0,0,0,1,1,2,0,Matches,2023
35,Arthur,br BRA,"MF,FW",Sporting CP,24,1998,1.2,2,2,1,1,0,0,0,,0,2,0,2,0,2,2,0,Matches,2023
36,Marco Asensio,es ESP,"FW,MF",Real Madrid,26,1996,3.6,1,0,0,1,0,1,2,50.0,1,4,0,4,5,6,3,0,Matches,2023
37,Kristjan Asllani,al ALB,MF,Inter,20,2002,1.4,4,1,2,1,1,2,2,100.0,0,0,0,0,2,6,5,0,Matches,2023
38,Omer Atzili,il ISR,"FW,MF",Maccabi Haifa,29,1993,3.4,7,3,2,3,2,2,9,22.2,7,2,0,2,3,10,1,0,Matches,2023
39,Pierre-Emerick Aubameyang,ga GAB,FW,Chelsea,33,1989,4.5,0,0,0,0,0,0,1,0.0,1,4,0,4,0,0,3,0,Matches,2023
40,Lynnt Audoor,be BEL,MF,Club Brugge,18,2003,0.1,1,0,0,0,1,0,0,,0,0,0,0,0,1,0,0,Matches,2023
41,Fredrik Aursnes,no NOR,"FW,MF",Benfica,26,1995,6.9,13,9,4,7,2,5,9,55.6,4,10,4,6,5,18,9,1,Matches,2023
42,Sardar Azmoun,ir IRN,FW,Leverkusen,27,1995,0.1,0,0,0,0,0,0,0,,0,0,0,0,0,0,0,0,Matches,2023
43,César Azpilicueta,es ESP,DF,Chelsea,32,1989,2.9,7,5,5,1,1,5,5,100.0,0,5,0,5,3,10,6,1,Matches,2023
44,Youri Baas,nl NED,DF,Ajax,19,2003,0.5,2,0,1,1,0,0,1,0.0,1,0,0,0,0,2,1,0,Matches,2023
45,Alexander Bah,dk DEN,DF,Benfica,24,1997,7.3,14,9,8,5,1,6,12,50.0,6,13,3,10,17,31,11,0,Matches,2023
46,Eric Bailly,ci CIV,DF,Marseille,28,1994,3.4,6,5,2,4,0,4,5,80.0,1,4,4,0,15,21,8,0,Matches,2023
47,Stefan Bajcetic,es ESP,MF,Liverpool,17,2004,1.2,6,4,1,3,2,5,6,83.3,1,0,0,0,1,7,0,0,Matches,2023
48,Mitchel Bakker,nl NED,"MF,DF",Leverkusen,22,2000,3.8,9,5,2,3,4,7,8,87.5,1,6,0,6,4,13,5,0,Matches,2023
49,Alejandro Balde,es ESP,DF,Barcelona,18,2003,1.9,0,0,0,0,0,0,1,0.0,1,2,0,2,0,0,1,0,Matches,2023
50,Leonardo Balerdi,ar ARG,DF,Marseille,23,1999,5.5,11,6,3,7,1,3,11,27.3,8,5,4,1,13,24,12,1,Matches,2023
51,Fodé Ballo-Touré,sn SEN,"DF,MF",Milan,25,1997,1.5,2,2,1,1,0,1,2,50.0,1,4,2,2,5,7,1,0,Matches,2023
52,Tommaso Barbieri,it ITA,MF,Juventus,19,2002,0.0,2,1,0,2,0,1,1,100.0,0,0,0,0,0,2,0,0,Matches,2023
53,Roony Bardghji,se SWE,FW,FC Copenhagen,16,2005,1.1,0,0,0,0,0,0,0,,0,0,0,0,0,0,1,0,Matches,2023
54,Nicolò Barella,it ITA,MF,Inter,25,1997,11.0,23,14,10,11,2,9,24,37.5,15,14,1,13,2,25,11,0,Matches,2023
55,Borna Barišić,hr CRO,DF,Rangers,29,1992,5.2,9,3,4,4,1,4,8,50.0,4,11,7,4,3,12,5,0,Matches,2023
56,Enzo Barrenechea,ar ARG,DF,Juventus,21,2001,0.0,0,0,0,0,0,0,0,,0,0,0,0,0,0,0,0,Matches,2023
57,Pablo Barrios,es ESP,MF,Atlético Madrid,19,2003,0.1,0,0,0,0,0,0,0,,0,0,0,0,0,0,0,0,Matches,2023
58,Calvin Bassey,ng NGA,DF,Ajax,22,1999,6.0,14,9,8,4,2,7,11,63.6,4,9,4,5,7,21,23,0,Matches,2023
59,Fortune Bassey,ng NGA,FW,Viktoria Plzeň,23,1998,1.5,0,0,0,0,0,0,2,0.0,2,0,0,0,0,0,0,0,Matches,2023
60,Alessandro Bastoni,it ITA,DF,Inter,23,1999,10.9,20,8,17,3,0,10,16,62.5,6,14,5,9,9,29,32,0,Matches,2023
61,Dylan Batubinsika,cd COD,DF,Maccabi Haifa,26,1996,5.0,8,1,7,1,0,3,5,60.0,2,3,1,2,10,18,14,0,Matches,2023
62,Martin Baturina,hr CRO,MF,Dinamo Zagreb,19,2003,0.7,3,1,2,0,1,2,2,100.0,0,1,0,1,0,3,0,0,Matches,2023
63,Raoul Bellanova,it ITA,"DF,MF",Inter,22,2000,1.3,2,1,2,0,0,1,3,33.3,2,2,0,2,1,3,2,0,Matches,2023
64,Héctor Bellerín,es ESP,DF,Barcelona,27,1995,2.0,4,3,1,2,1,2,3,66.7,1,3,2,1,1,5,1,0,Matches,2023
65,Jude Bellingham,eng ENG,MF,Dortmund,19,2003,7.0,15,8,9,3,3,8,16,50.0,8,15,4,11,13,28,8,0,Matches,2023
66,Ismaël Bennacer,dz ALG,MF,Milan,24,1997,6.5,26,13,11,10,5,5,10,50.0,5,5,0,5,7,33,2,0,Matches,2023
67,Rodrigo Bentancur,uy URU,"MF,FW",Tottenham,25,1997,5.6,12,7,4,7,1,6,8,75.0,2,5,2,3,5,17,4,0,Matches,2023
68,Karim Benzema,fr FRA,FW,Real Madrid,34,1987,8.3,2,2,1,0,1,0,1,0.0,1,5,0,5,0,2,8,0,Matches,2023
69,Steven Berghuis,nl NED,"MF,FW",Ajax,30,1991,5.1,13,9,2,8,3,7,10,70.0,3,5,0,5,4,17,0,0,Matches,2023
70,Steven Bergwijn,nl NED,FW,Ajax,24,1997,5.8,3,1,0,1,2,1,1,100.0,0,2,0,2,1,4,1,0,Matches,2023
71,Alexandro Bernabei,ar ARG,FW,Celtic,21,2000,0.1,0,0,0,0,0,0,0,,0,1,0,1,0,0,1,0,Matches,2023
72,Bernardo,br BRA,DF,RB Salzburg,27,1995,3.0,10,6,9,1,0,4,7,57.1,3,6,3,3,5,15,16,1,Matches,2023
73,Juan Bernat,es ESP,DF,Paris S-G,29,1993,3.1,11,7,9,1,1,7,10,70.0,3,3,1,2,1,12,2,0,Matches,2023
74,Victor Bernth Kristiansen,dk DEN,"DF,MF",FC Copenhagen,19,2002,5.4,15,6,9,3,3,5,7,71.4,2,11,1,10,6,21,14,0,Matches,2023
75,Modou Biramé Ndiaye,sn SEN,MF,Viktoria Plzeň,25,1996,2.0,4,1,3,1,0,2,8,25.0,6,2,0,2,6,10,4,0,Matches,2023
76,Yves Bissouma,ml MLI,MF,Tottenham,25,1996,1.0,2,1,2,0,0,1,2,50.0,1,4,1,3,2,4,2,0,Matches,2023
77,Janis Blaswich,de GER,GK,RB Leipzig,31,1991,5.9,0,0,0,0,0,0,0,,0,0,0,0,0,0,2,0,Matches,2023
78,Daley Blind,nl NED,DF,Ajax,32,1990,4.5,17,10,6,6,5,10,14,71.4,4,6,2,4,4,21,9,1,Matches,2023
79,Petar Bočkaj,hr CRO,"DF,FW",Dinamo Zagreb,26,1996,0.4,1,0,0,0,1,0,0,,0,0,0,0,0,1,0,0,Matches,2023
80,Nicolai Boilesen,dk DEN,DF,FC Copenhagen,30,1992,1.1,0,0,0,0,0,0,1,0.0,1,2,1,1,2,2,3,0,Matches,2023
81,Valerii Bondar,ua UKR,DF,Shakhtar,23,1999,6.0,7,5,5,2,0,2,3,66.7,1,11,9,2,7,14,30,1,Matches,2023
82,Artem Bondarenko,ua UKR,MF,Shakhtar,21,2000,5.4,14,4,10,2,2,5,9,55.6,4,1,0,1,7,21,6,0,Matches,2023
83,Leonardo Bonucci,it ITA,DF,Juventus,35,1987,4.9,2,0,1,1,0,2,4,50.0,2,6,6,0,2,4,14,0,Matches,2023
84,Gonçalo Borges,pt POR,"MF,FW",Porto,21,2001,0.4,1,0,1,0,0,0,0,,0,0,0,0,0,1,0,0,Matches,2023
85,Rafael Borré,co COL,FW,Eint Frankfurt,26,1995,2.5,2,1,0,0,2,0,7,0.0,7,3,0,3,0,2,1,0,Matches,2023
86,Yassine Bounou,ma MAR,GK,Sevilla,31,1991,4.0,0,0,0,0,0,0,1,0.0,1,0,0,0,0,0,3,2,Matches,2023
87,Dedryck Boyata,be BEL,DF,Club Brugge,31,1990,1.5,1,0,1,0,0,1,1,100.0,0,1,1,0,7,8,7,0,Matches,2023
88,Julian Brandt,de GER,"MF,FW",Dortmund,26,1996,5.3,7,3,2,3,2,2,10,20.0,8,5,1,4,2,9,4,0,Matches,2023
89,Gleison Bremer,br BRA,DF,Juventus,25,1997,3.0,6,3,5,1,0,2,5,40.0,3,6,2,4,5,11,13,0,Matches,2023
90,Brian Brobbey,nl NED,FW,Ajax,20,2002,1.3,0,0,0,0,0,0,0,,0,0,0,0,0,0,0,0,Matches,2023
91,Armando Broja,al ALB,FW,Chelsea,20,2001,1.3,2,1,0,0,2,0,1,0.0,1,1,1,0,0,2,0,0,Matches,2023
92,Marcelo Brozović,hr CRO,MF,Inter,29,1992,6.1,18,11,12,4,2,7,18,38.9,11,9,5,4,9,27,5,1,Matches,2023
93,Pavel Bucha,cz CZE,MF,Viktoria Plzeň,24,1998,4.0,6,3,4,2,0,5,9,55.6,4,3,0,3,2,8,2,0,Matches,2023
94,Tajon Buchanan,ca CAN,"DF,MF",Club Brugge,23,1999,5.8,9,4,8,0,1,5,10,50.0,5,3,0,3,0,9,4,0,Matches,2023
95,Marko Bulat,hr CRO,MF,Dinamo Zagreb,20,2001,0.3,2,1,2,0,0,1,1,100.0,0,0,0,0,0,2,2,0,Matches,2023
96,Sergio Busquets,es ESP,MF,Barcelona,34,1988,3.2,8,8,1,6,1,4,7,57.1,3,2,0,2,4,12,2,1,Matches,2023
97,Aurélio Buta,pt POR,DF,Eint Frankfurt,25,1997,1.8,5,4,3,2,0,3,4,75.0,1,5,1,4,1,6,4,0,Matches,2023
98,Jamie Bynoe-Gittens,eng ENG,MF,Dortmund,17,2004,0.4,0,0,0,0,0,0,1,0.0,1,1,0,1,0,0,1,0,Matches,2023
99,Jovane Cabral,cv CPV,MF,Sporting CP,24,1998,0.1,0,0,0,0,0,0,0,,0,0,0,0,0,0,0,0,Matches,2023
100,Davide Calabria,it ITA,DF,Milan,25,1996,5.5,17,10,15,2,0,10,20,50.0,10,9,3,6,15,32,12,0,Matches,2023
101,Hakan Çalhanoğlu,tr TUR,MF,Inter,28,1994,8.9,16,11,5,8,3,8,20,40.0,12,5,3,2,8,24,7,0,Matches,2023
102,Eduardo Camavinga,fr FRA,"MF,DF",Real Madrid,19,2002,8.0,26,17,17,6,3,11,32,34.4,21,12,0,12,6,32,11,0,Matches,2023
103,Emre Can,de GER,MF,Dortmund,28,1994,6.3,16,12,7,8,1,7,11,63.6,4,13,4,9,13,29,6,1,Matches,2023
104,João Cancelo,pt POR,DF,Bayern Munich,28,1994,1.4,4,2,3,1,0,3,7,42.9,4,3,0,3,0,4,0,0,Matches,2023
105,João Cancelo,pt POR,DF,Manchester City,28,1994,4.2,10,7,3,5,2,4,8,50.0,4,3,0,3,3,13,3,0,Matches,2023
106,Nicolás Capaldo,ar ARG,MF,RB Salzburg,24,1997,3.0,8,4,5,2,1,5,8,62.5,3,9,0,9,4,12,9,0,Matches,2023
107,Valentin Carboni,ar ARG,FW,Inter,17,2005,0.2,0,0,0,0,0,0,1,0.0,1,0,0,0,0,0,0,0,Matches,2023
108,Fábio Cardoso,pt POR,DF,Porto,28,1994,4.0,7,3,5,1,1,4,6,66.7,2,3,1,2,3,10,15,0,Matches,2023
109,David Carmo,pt POR,DF,Porto,23,1999,5.0,5,2,4,1,0,1,5,20.0,4,2,1,1,4,9,16,0,Matches,2023
110,Carmona,es ESP,DF,Sevilla,20,2002,5.0,6,4,5,0,1,3,7,42.9,4,7,4,3,3,9,10,1,Matches,2023
111,Yannick Carrasco,be BEL,"DF,MF",Atlético Madrid,28,1993,3.0,7,4,3,3,1,4,8,50.0,4,6,0,6,1,8,1,0,Matches,2023
112,Cameron Carter-Vickers,us USA,DF,Celtic,24,1997,4.0,3,2,2,1,0,2,4,50.0,2,2,1,1,4,7,15,0,Matches,2023
113,Dani Carvajal,es ESP,DF,Real Madrid,30,1992,9.7,18,11,10,6,2,10,19,52.6,9,15,4,11,7,25,20,0,Matches,2023
114,Fabio Carvalho,pt POR,"MF,FW",Liverpool,19,2002,1.3,2,1,0,2,0,0,4,0.0,4,3,1,2,0,2,0,0,Matches,2023
115,Marc Casado,es ESP,MF,Barcelona,18,2003,0.3,0,0,0,0,0,0,0,,0,2,1,1,0,0,1,0,Matches,2023
116,Dani Ceballos,es ESP,MF,Real Madrid,25,1996,1.0,4,1,0,4,0,1,1,100.0,0,6,0,6,0,4,0,0,Matches,2023
117,Aleš Čermák,cz CZE,MF,Viktoria Plzeň,27,1994,0.4,2,1,0,1,1,0,0,,0,1,0,1,2,4,0,0,Matches,2023
118,El Chadaille Bitshiabu,fr FRA,DF,Paris S-G,17,2005,0.5,1,1,1,0,0,0,0,,0,1,1,0,0,1,2,0,Matches,2023
119,Trevoh Chalobah,eng ENG,DF,Chelsea,23,1999,4.9,8,6,6,2,0,5,10,50.0,5,4,4,0,5,13,17,0,Matches,2023
120,Timothy Chandler,us USA,DF,Eint Frankfurt,32,1990,0.1,0,0,0,0,0,0,0,,0,0,0,0,0,0,0,0,Matches,2023
121,Tjaronn Chery,sr SUR,"MF,FW",Maccabi Haifa,34,1988,6.0,2,1,0,2,0,0,3,0.0,3,5,0,5,1,3,2,0,Matches,2023
122,Federico Chiesa,it ITA,FW,Juventus,24,1997,0.2,0,0,0,0,0,0,0,,0,2,0,2,0,0,0,0,Matches,2023
123,Ben Chilwell,eng ENG,"DF,MF",Chelsea,25,1996,6.2,12,8,4,6,2,4,7,57.1,3,8,4,4,4,16,5,0,Matches,2023
124,Chiquinho,pt POR,MF,Benfica,27,1995,4.5,11,6,5,3,3,3,7,42.9,4,5,2,3,7,18,4,0,Matches,2023
125,Tomáš Chorý,cz CZE,FW,Viktoria Plzeň,27,1995,4.0,3,1,0,0,3,1,3,33.3,2,4,0,4,1,4,6,0,Matches,2023
126,Andreas Christensen,dk DEN,DF,Barcelona,26,1996,2.4,4,1,2,1,1,1,1,100.0,0,2,2,0,3,7,4,0,Matches,2023
127,Viktor Claesson,se SWE,"FW,MF",FC Copenhagen,30,1992,5.4,9,8,7,1,1,4,6,66.7,2,4,2,2,9,18,8,0,Matches,2023
128,Jonathan Clauss,fr FRA,DF,Marseille,29,1992,4.6,6,1,3,3,0,2,5,40.0,3,4,1,3,5,11,2,0,Matches,2023
129,William Clem,dk DEN,MF,FC Copenhagen,18,2004,1.9,5,2,3,0,2,2,7,28.6,5,2,0,2,4,9,0,0,Matches,2023
130,Sebastián Coates,uy URU,DF,Sporting CP,31,1990,4.4,8,3,6,2,0,5,6,83.3,1,4,2,2,6,14,18,1,Matches,2023
131,Josh Cohen,us USA,GK,Maccabi Haifa,29,1992,6.0,0,0,0,0,0,0,0,,0,0,0,0,0,0,2,0,Matches,2023
132,Antonio Čolak,hr CRO,FW,Rangers,28,1993,3.2,0,0,0,0,0,0,3,0.0,3,0,0,0,1,1,2,0,Matches,2023
133,Kingsley Coman,fr FRA,"FW,DF",Bayern Munich,26,1996,5.9,11,8,3,6,2,5,13,38.5,8,10,0,10,2,13,1,0,Matches,2023
134,Francisco Conceição,pt POR,"FW,MF",Ajax,19,2002,0.2,0,0,0,0,0,0,0,,0,1,0,1,0,0,1,0,Matches,2023
135,Rodrigo Conceição,pt POR,DF,Porto,22,2000,0.1,1,1,1,0,0,1,1,100.0,0,0,0,0,0,1,1,0,Matches,2023
136,Andreas Cornelius,dk DEN,FW,FC Copenhagen,29,1993,1.2,1,1,0,1,0,0,0,,0,3,0,3,0,1,1,0,Matches,2023
137,Pierre Cornud,fr FRA,DF,Maccabi Haifa,25,1996,4.1,11,4,7,2,2,5,7,71.4,2,4,1,3,3,14,10,0,Matches,2023
138,Ángel Correa,ar ARG,"FW,MF",Atlético Madrid,27,1995,3.5,2,0,0,1,1,2,3,66.7,1,9,2,7,0,2,0,1,Matches,2023
139,Joaquín Correa,ar ARG,FW,Inter,27,1994,3.4,2,1,1,1,0,0,4,0.0,4,1,0,1,0,2,1,0,Matches,2023
140,Bruno Xavier Almeida Costa,pt POR,MF,Porto,25,1997,0.8,2,2,1,1,0,1,1,100.0,0,0,0,0,1,3,0,0,Matches,2023
141,Diogo Costa,pt POR,GK,Porto,22,1999,8.0,0,0,0,0,0,0,0,,0,0,0,0,0,0,3,0,Matches,2023
142,Soumaïla Coulibaly,fr FRA,DF,Dortmund,18,2003,0.2,0,0,0,0,0,0,0,,0,0,0,0,1,1,1,0,Matches,2023
143,Thibaut Courtois,be BEL,GK,Real Madrid,30,1992,10.0,1,1,1,0,0,0,2,0.0,2,0,0,0,0,1,3,1,Matches,2023
144,Juan Cuadrado,co COL,"DF,MF",Juventus,34,1988,4.8,12,7,8,4,0,8,12,66.7,4,7,0,7,8,20,4,0,Matches,2023
145,Marc Cucurella,es ESP,DF,Chelsea,24,1998,4.6,12,9,6,5,1,8,8,100.0,0,9,0,9,8,20,7,0,Matches,2023
146,Matheus Cunha,br BRA,"FW,MF",Atlético Madrid,23,1999,1.4,2,1,0,0,2,1,1,100.0,0,4,0,4,1,3,0,0,Matches,2023
147,Danilo D'Ambrosio,it ITA,DF,Inter,33,1988,1.8,3,1,0,2,1,2,6,33.3,4,1,1,0,4,7,5,0,Matches,2023
148,Danilo,br BRA,DF,Juventus,31,1991,4.7,7,2,6,1,0,3,6,50.0,3,3,0,3,7,14,11,0,Matches,2023
149,Arnaut Danjuma,nl NED,MF,Tottenham,25,1997,0.1,0,0,0,0,0,0,0,,0,0,0,0,0,0,0,0,Matches,2023
150,Mohammed Daramy,dk DEN,FW,FC Copenhagen,20,2002,4.9,2,1,1,1,0,1,3,33.3,2,2,1,1,4,6,0,0,Matches,2023
151,Matteo Darmian,it ITA,DF,Inter,32,1989,9.1,20,11,14,6,0,8,20,40.0,12,9,4,5,19,39,28,0,Matches,2023
152,Dean David,il ISR,"FW,DF",Maccabi Haifa,26,1996,2.6,3,2,2,0,1,1,2,50.0,1,0,0,0,0,3,0,0,Matches,2023
153,Alphonso Davies,ca CAN,DF,Bayern Munich,21,2000,6.7,22,10,16,5,1,9,15,60.0,6,15,5,10,8,30,12,0,Matches,2023
154,Ben Davies,wls WAL,DF,Tottenham,29,1993,4.4,7,6,0,5,2,3,6,50.0,3,3,2,1,5,12,13,1,Matches,2023
155,Ben Davies,eng ENG,DF,Rangers,26,1995,2.9,3,1,2,1,0,0,0,,0,3,3,0,4,7,13,0,Matches,2023
156,Steven Davis,nir NIR,MF,Rangers,37,1985,2.8,5,4,2,2,1,1,1,100.0,0,4,0,4,2,7,3,0,Matches,2023
157,Kevin De Bruyne,be BEL,MF,Manchester City,31,1991,8.0,9,3,1,5,3,2,9,22.2,7,4,0,4,2,11,5,0,Matches,2023
158,Charles De Ketelaere,be BEL,"MF,FW",Milan,21,2001,2.6,2,1,2,0,0,1,4,25.0,3,7,1,6,3,5,0,0,Matches,2023
159,Rodrigo De Paul,ar ARG,MF,Atlético Madrid,28,1994,2.8,4,2,1,1,2,1,3,33.3,2,7,0,7,3,7,2,0,Matches,2023
160,Mattia De Sciglio,it ITA,DF,Juventus,29,1992,1.1,1,1,0,1,0,1,1,100.0,0,1,0,1,1,2,0,0,Matches,2023
161,Amar Dedić,ba BIH,DF,RB Salzburg,19,2002,6.0,19,11,13,5,1,10,12,83.3,2,5,1,4,9,28,19,1,Matches,2023
162,Thomas Delaney,dk DEN,MF,Sevilla,30,1991,2.6,2,2,0,2,0,1,3,33.3,2,2,1,1,1,3,5,0,Matches,2023
163,Ousmane Dembélé,fr FRA,FW,Barcelona,25,1997,4.6,11,7,3,4,4,4,5,80.0,1,1,0,1,2,13,0,0,Matches,2023
164,Kerem Demirbay,de GER,MF,Leverkusen,29,1993,3.0,7,5,1,6,0,1,6,16.7,5,3,0,3,3,10,1,0,Matches,2023
165,Sergiño Dest,us USA,DF,Milan,21,2000,2.1,4,1,2,1,1,2,4,50.0,2,3,1,2,1,5,0,0,Matches,2023
166,Giovanni Di Lorenzo,it ITA,DF,Napoli,28,1993,9.9,18,10,12,6,0,10,15,66.7,5,9,3,6,12,30,22,0,Matches,2023
167,Ángel Di María,ar ARG,FW,Juventus,34,1988,1.6,1,0,0,0,1,0,0,,0,0,0,0,0,1,0,0,Matches,2023
168,Moussa Diaby,fr FRA,"FW,MF",Leverkusen,23,1999,5.6,4,2,1,2,1,2,3,66.7,1,4,0,4,0,4,0,0,Matches,2023
169,Abdou Diallo,sn SEN,"DF,MF",RB Leipzig,26,1996,2.5,4,2,2,2,0,1,2,50.0,1,1,1,0,1,5,4,0,Matches,2023
170,Rúben Dias,pt POR,DF,Manchester City,25,1997,11.7,26,18,13,11,2,15,18,83.3,3,14,8,6,7,33,25,0,Matches,2023
171,Brahim Díaz,es ESP,"MF,FW",Milan,22,1999,6.7,7,3,4,3,0,2,4,50.0,2,5,1,4,6,13,0,0,Matches,2023
172,Luis Díaz,co COL,FW,Liverpool,25,1997,3.0,4,2,2,0,2,2,3,66.7,1,3,1,2,0,4,0,0,Matches,2023
173,Eric Dier,eng ENG,DF,Tottenham,28,1994,6.9,7,5,1,6,0,2,5,40.0,3,4,3,1,8,15,23,2,Matches,2023
174,Kevin Diks,nl NED,DF,FC Copenhagen,25,1996,3.7,13,7,7,3,3,6,7,85.7,1,7,4,3,4,17,10,0,Matches,2023
175,Federico Dimarco,it ITA,DF,Inter,24,1997,8.1,9,6,3,6,0,6,16,37.5,10,10,3,7,10,19,19,0,Matches,2023
176,Junior Dina Ebimbe,fr FRA,"MF,DF",Eint Frankfurt,21,2000,2.7,8,6,3,5,0,2,5,40.0,3,0,0,0,1,9,4,0,Matches,2023
177,Marko Dmitrović,rs SRB,GK,Sevilla,30,1992,2.0,0,0,0,0,0,0,0,,0,1,0,1,0,0,0,0,Matches,2023
178,Matt Doherty,ie IRL,DF,Tottenham,30,1992,0.8,1,1,1,0,0,1,1,100.0,0,2,0,2,2,3,1,0,Matches,2023
179,Kasper Dolberg,dk DEN,FW,Sevilla,24,1997,1.2,0,0,0,0,0,0,0,,0,2,0,2,1,1,1,0,Matches,2023
180,Gianluigi Donnarumma,it ITA,GK,Paris S-G,23,1999,8.0,0,0,0,0,0,0,0,,0,0,0,0,0,0,7,1,Matches,2023
181,Julian Draxler,de GER,MF,Benfica,28,1993,0.4,1,0,1,0,0,0,1,0.0,1,0,0,0,0,1,0,0,Matches,2023
182,Josip Drmić,ch SUI,FW,Dinamo Zagreb,29,1992,1.1,0,0,0,0,0,0,1,0.0,1,0,0,0,0,0,2,0,Matches,2023
183,Denzel Dumfries,nl NED,DF,Inter,26,1996,9.8,9,6,5,2,2,5,11,45.5,6,14,4,10,8,17,19,0,Matches,2023
184,Edin Džeko,ba BIH,FW,Inter,36,1986,9.2,4,2,2,1,1,3,7,42.9,4,11,2,9,0,4,16,0,Matches,2023
185,Ederson,br BRA,GK,Manchester City,28,1993,11.0,0,0,0,0,0,0,0,,0,0,0,0,0,0,5,0,Matches,2023
186,Jorge Eduardo Sánchez,mx MEX,DF,Ajax,24,1997,3.0,10,4,6,3,1,7,11,63.6,4,3,1,2,2,12,9,0,Matches,2023
187,Marcus Edwards,eng ENG,"FW,MF",Sporting CP,23,1998,3.9,3,0,3,0,0,1,6,16.7,5,1,0,1,1,4,1,0,Matches,2023
188,Hugo Ekitike,fr FRA,"MF,FW",Paris S-G,20,2002,0.7,1,1,0,1,0,1,1,100.0,0,0,0,0,0,1,0,0,Matches,2023
189,Harvey Elliott,eng ENG,MF,Liverpool,19,2003,4.4,8,5,2,6,0,4,8,50.0,4,10,0,10,5,13,4,0,Matches,2023
190,Elif Elmas,mk MKD,"FW,MF",Napoli,22,1999,3.2,8,1,1,7,0,5,10,50.0,5,5,1,4,0,8,2,0,Matches,2023
191,Emerson,br BRA,"DF,MF",Tottenham,23,1999,6.0,18,11,4,6,8,7,14,50.0,7,4,0,4,3,21,13,0,Matches,2023
192,Youssef En-Nesyri,ma MAR,FW,Sevilla,25,1997,2.7,3,2,0,0,3,2,4,50.0,2,1,0,1,2,5,3,0,Matches,2023
193,Ricardo Esgaio,pt POR,"DF,MF",Sporting CP,29,1993,1.2,8,5,4,3,1,7,9,77.8,2,2,0,2,0,8,1,0,Matches,2023
194,Dario Essugo,pt POR,MF,Sporting CP,17,2005,0.3,2,2,0,2,0,0,0,,0,1,1,0,0,2,0,0,Matches,2023
195,Stephen Eustáquio,ca CAN,MF,Porto,25,1996,6.6,14,7,8,6,0,5,14,35.7,9,7,1,6,11,25,9,0,Matches,2023
196,Evanilson,br BRA,FW,Porto,22,1999,5.7,4,3,0,3,1,1,4,25.0,3,4,1,3,1,5,4,0,Matches,2023
197,Fabinho,br BRA,MF,Liverpool,28,1993,7.0,13,8,4,8,1,2,11,18.2,9,8,3,5,9,22,5,0,Matches,2023
198,Nicolò Fagioli,it ITA,MF,Juventus,21,2001,1.2,2,0,1,1,0,0,3,0.0,3,4,0,4,1,3,0,0,Matches,2023
199,Rasmus Falk,dk DEN,MF,FC Copenhagen,30,1992,2.1,2,1,1,1,0,1,4,25.0,3,3,0,3,7,9,2,0,Matches,2023
200,Abdul Fatawu Issahaku,gh GHA,"MF,DF",Sporting CP,18,2004,1.0,4,3,3,1,0,0,0,,0,1,0,1,0,4,2,0,Matches,2023
201,Ansu Fati,es ESP,FW,Barcelona,19,2002,2.7,1,1,0,1,0,0,1,0.0,1,2,0,2,0,1,0,0,Matches,2023
202,Felipe,br BRA,DF,Atlético Madrid,33,1989,1.0,4,4,3,1,0,1,1,100.0,0,4,3,1,1,5,5,1,Matches,2023
203,João Félix,pt POR,"FW,MF",Chelsea,22,1999,2.7,2,1,2,0,0,2,5,40.0,3,0,0,0,0,2,0,0,Matches,2023
204,João Félix,pt POR,FW,Atlético Madrid,22,1999,2.4,2,0,0,1,1,1,1,100.0,0,1,0,1,0,2,0,0,Matches,2023
205,Mateus Fernandes,pt POR,MF,Sporting CP,18,2004,0.3,1,0,1,0,0,1,1,100.0,0,2,1,1,0,1,2,0,Matches,2023
206,Enzo Fernández,ar ARG,MF,Benfica,21,2001,4.7,19,7,7,8,4,8,13,61.5,5,4,1,3,9,28,2,0,Matches,2023
207,Enzo Fernández,ar ARG,MF,Chelsea,21,2001,3.7,8,7,2,5,1,4,10,40.0,6,10,2,8,1,9,3,0,Matches,2023
208,Fernando,br BRA,FW,RB Salzburg,23,1999,0.7,1,0,0,0,1,1,2,50.0,1,3,0,3,1,2,0,0,Matches,2023
209,Fernando,br BRA,MF,Sevilla,35,1987,1.0,0,0,0,0,0,0,1,0.0,1,0,0,0,1,1,0,0,Matches,2023
210,Roberto Firmino,br BRA,"FW,MF",Liverpool,30,1991,4.6,8,2,3,5,0,1,2,50.0,1,7,0,7,6,14,2,0,Matches,2023
211,Phil Foden,eng ENG,"MF,FW",Manchester City,22,2000,4.3,5,4,2,1,2,2,3,66.7,1,3,0,3,5,10,0,0,Matches,2023
212,Wesley Fofana,fr FRA,DF,Chelsea,21,2000,4.4,15,9,8,7,0,10,17,58.8,7,2,0,2,4,19,9,0,Matches,2023
213,Bernardo Folha,pt POR,MF,Porto,20,2002,0.1,1,1,1,0,0,0,0,,0,0,0,0,0,1,0,0,Matches,2023
214,James Forrest,sct SCO,FW,Celtic,31,1991,1.0,1,1,0,1,0,0,1,0.0,1,2,0,2,1,2,1,0,Matches,2023
215,Emil Forsberg,se SWE,"MF,FW",RB Leipzig,30,1991,4.5,8,4,2,3,3,4,12,33.3,8,4,0,4,1,9,1,0,Matches,2023
216,Fraser Forster,eng ENG,GK,Tottenham,34,1988,2.0,0,0,0,0,0,0,0,,0,0,0,0,0,0,0,0,Matches,2023
217,Timothy Fosu-Mensah,nl NED,"MF,DF",Leverkusen,24,1998,0.1,1,1,0,0,1,0,0,,0,0,0,0,1,2,0,0,Matches,2023
218,Lassina Franck Traoré,bf BFA,FW,Shakhtar,21,2001,2.7,0,0,0,0,0,0,0,,0,0,0,0,0,0,3,0,Matches,2023
219,André Franco,pt POR,MF,Porto,24,1998,0.2,1,1,1,0,0,0,0,,0,0,0,0,0,1,0,0,Matches,2023
220,Jeremie Frimpong,nl NED,"MF,FW",Leverkusen,21,2000,4.2,8,5,3,3,2,7,11,63.6,4,4,1,3,5,13,7,0,Matches,2023
221,Kyogo Furuhashi,jp JPN,FW,Celtic,27,1995,4.0,2,0,1,0,1,1,1,100.0,0,4,0,4,0,2,1,0,Matches,2023
222,Matteo Gabbia,it ITA,DF,Milan,22,1999,2.3,3,1,2,1,0,3,3,100.0,0,1,0,1,3,6,10,0,Matches,2023
223,Gianluca Gaetano,it ITA,MF,Napoli,22,2000,0.3,0,0,0,0,0,0,0,,0,0,0,0,0,0,0,0,Matches,2023
224,Roberto Gagliardini,it ITA,MF,Inter,28,1994,1.3,6,2,1,3,2,1,4,25.0,3,8,0,8,2,8,1,0,Matches,2023
225,Cody Gakpo,nl NED,"FW,MF",Liverpool,23,1999,1.7,6,5,2,1,3,4,5,80.0,1,4,1,3,1,7,1,0,Matches,2023
226,Galeno,br BRA,"FW,MF",Porto,24,1997,6.3,3,1,2,1,0,2,4,50.0,2,14,3,11,10,13,5,0,Matches,2023
227,Conor Gallagher,eng ENG,MF,Chelsea,22,2000,3.3,9,6,4,3,2,4,9,44.4,5,0,0,0,5,14,4,0,Matches,2023
228,Eric García,es ESP,DF,Barcelona,21,2001,2.5,4,2,3,1,0,2,3,66.7,1,1,0,1,4,8,5,0,Matches,2023
229,Federico Gatti,it ITA,DF,Juventus,24,1998,2.0,2,2,2,0,0,2,4,50.0,2,3,1,2,2,4,7,0,Matches,2023
230,Gavi,es ESP,MF,Barcelona,17,2004,3.7,7,6,2,3,2,2,4,50.0,2,4,1,3,5,12,1,0,Matches,2023
231,Gerson,br BRA,MF,Marseille,25,1997,1.3,1,1,1,0,0,0,0,,0,2,0,2,0,1,0,0,Matches,2023
232,Giorgos Giakoumakis,gr GRE,FW,Celtic,27,1994,2.7,4,3,1,0,3,0,2,0.0,2,5,0,5,4,8,3,0,Matches,2023
233,Samuel Gigot,fr FRA,DF,Marseille,28,1993,2.8,0,0,0,0,0,0,1,0.0,1,6,3,3,4,4,5,0,Matches,2023
234,Bryan Gil,es ESP,MF,Tottenham,21,2001,0.4,0,0,0,0,0,0,2,0.0,2,2,0,2,2,2,0,0,Matches,2023
235,Gilberto,br BRA,DF,Benfica,29,1993,2.2,5,5,4,1,0,3,6,50.0,3,3,0,3,6,11,5,0,Matches,2023
236,Olivier Giroud,fr FRA,FW,Milan,35,1986,10.4,7,6,1,5,1,3,9,33.3,6,7,0,7,2,9,15,0,Matches,2023
237,Serge Gnabry,de GER,"FW,MF",Bayern Munich,27,1995,3.8,8,3,4,3,1,2,11,18.2,9,6,0,6,0,8,2,0,Matches,2023
238,Sean Goldberg,il ISR,DF,Maccabi Haifa,27,1995,6.0,10,6,7,3,0,4,6,66.7,2,6,4,2,4,14,24,0,Matches,2023
239,Connor Goldson,eng ENG,DF,Rangers,29,1992,3.5,6,3,1,5,0,3,7,42.9,4,8,3,5,5,11,19,0,Matches,2023
240,Joe Gomez,eng ENG,DF,Liverpool,25,1997,3.3,4,2,2,2,0,3,3,100.0,0,2,1,1,5,9,6,2,Matches,2023
241,Papu Gómez,ar ARG,"FW,MF",Sevilla,34,1988,2.7,2,2,0,1,1,1,3,33.3,2,0,0,0,3,5,0,0,Matches,2023
242,Sergio Gómez,es ESP,"DF,MF",Manchester City,21,2000,3.4,4,1,2,2,0,1,2,50.0,1,4,0,4,2,6,2,0,Matches,2023
243,Diogo Gonçalves,pt POR,"FW,MF",Benfica,25,1997,0.4,1,0,1,0,0,1,1,100.0,0,0,0,0,0,1,0,0,Matches,2023
244,Pedro Gonçalves,pt POR,"MF,FW",Sporting CP,24,1998,4.0,8,4,3,3,2,5,7,71.4,2,5,0,5,3,11,0,0,Matches,2023
245,Leon Goretzka,de GER,MF,Bayern Munich,27,1995,6.7,16,9,6,7,3,6,17,35.3,11,13,3,10,7,23,7,1,Matches,2023
246,Robin Gosens,de GER,DF,Inter,28,1994,4.7,20,13,13,5,2,10,14,71.4,4,1,0,1,5,25,10,0,Matches,2023
247,Mario Götze,de GER,"MF,FW",Eint Frankfurt,30,1992,5.8,7,3,2,3,2,4,12,33.3,8,5,1,4,3,10,2,0,Matches,2023
248,Lucas Gourna-Douath,fr FRA,MF,RB Salzburg,18,2003,3.5,12,6,2,10,0,5,9,55.6,4,3,0,3,4,16,1,0,Matches,2023
249,Kamil Grabara,pl POL,GK,FC Copenhagen,23,1999,4.0,0,0,0,0,0,0,1,0.0,1,0,0,0,0,0,1,0,Matches,2023
250,Ryan Gravenberch,nl NED,MF,Bayern Munich,20,2002,2.8,6,5,2,3,1,2,3,66.7,1,2,1,1,3,9,3,0,Matches,2023
251,Ivo Grbić,hr CRO,GK,Atlético Madrid,26,1996,1.0,0,0,0,0,0,0,1,0.0,1,0,0,0,0,0,0,0,Matches,2023
252,Jack Grealish,eng ENG,FW,Manchester City,26,1995,10.4,8,5,4,3,1,5,13,38.5,8,10,3,7,4,12,6,0,Matches,2023
253,Antoine Griezmann,fr FRA,"FW,MF",Atlético Madrid,31,1991,4.5,7,5,3,3,1,4,7,57.1,3,5,1,4,2,9,1,0,Matches,2023
254,Florian Grillitsch,at AUT,MF,Ajax,26,1995,0.7,1,1,1,0,0,1,6,16.7,5,1,0,1,0,1,0,0,Matches,2023
255,Álex Grimaldo,es ESP,DF,Benfica,26,1995,10.0,25,10,11,8,6,16,33,48.5,17,13,4,9,13,38,17,0,Matches,2023
256,Marko Grujić,rs SRB,MF,Porto,26,1996,3.1,5,5,4,0,1,2,3,66.7,1,4,1,3,4,9,11,0,Matches,2023
257,Nemanja Gudelj,rs SRB,"DF,MF",Sevilla,30,1991,5.5,3,2,2,0,1,1,8,12.5,7,4,2,2,2,5,14,0,Matches,2023
258,Gonçalo Guedes,pt POR,"FW,MF",Benfica,25,1996,0.5,0,0,0,0,0,0,0,,0,0,0,0,0,0,1,0,Matches,2023
259,Mattéo Guendouzi,fr FRA,MF,Marseille,23,1999,4.6,4,3,1,2,1,3,5,60.0,2,3,2,1,6,10,1,0,Matches,2023
260,Raphaël Guerreiro,pt POR,DF,Dortmund,28,1993,5.3,7,4,2,3,2,1,4,25.0,3,5,2,3,10,17,10,0,Matches,2023
261,Pape Gueye,sn SEN,MF,Marseille,23,1999,0.4,1,0,1,0,0,0,0,,0,0,0,0,1,2,0,0,Matches,2023
262,Péter Gulácsi,hu HUN,GK,RB Leipzig,32,1990,2.1,0,0,0,0,0,0,0,,0,0,0,0,0,0,0,2,Matches,2023
263,İlkay Gündoğan,de GER,MF,Manchester City,31,1990,11.0,12,8,5,4,3,4,12,33.3,8,8,1,7,7,19,6,0,Matches,2023
264,Joško Gvardiol,hr CRO,DF,RB Leipzig,20,2002,6.0,9,6,5,4,0,4,10,40.0,6,3,2,1,4,13,25,1,Matches,2023
265,Erling Haaland,no NOR,FW,Manchester City,22,2000,9.3,1,0,0,1,0,1,2,50.0,1,5,0,5,2,3,3,0,Matches,2023
266,Amadou Haidara,ml MLI,MF,RB Leipzig,24,1998,3.8,12,9,4,7,1,4,5,80.0,1,5,1,4,10,22,4,0,Matches,2023
267,Achraf Hakimi,ma MAR,"DF,MF",Paris S-G,23,1998,6.4,9,6,4,4,1,3,12,25.0,9,2,0,2,8,17,7,0,Matches,2023
268,Sead Haksabanović,me MNE,"MF,FW",Celtic,23,1999,2.5,5,3,2,0,3,5,5,100.0,0,2,0,2,2,7,1,0,Matches,2023
269,Sébastien Haller,ci CIV,FW,Dortmund,28,1994,1.6,0,0,0,0,0,0,0,,0,1,0,1,0,0,0,0,Matches,2023
270,Marcel Halstenberg,de GER,DF,RB Leipzig,30,1991,1.9,1,0,0,1,0,0,3,0.0,3,2,0,2,6,7,2,0,Matches,2023
271,Amine Harit,ma MAR,MF,Marseille,25,1997,4.2,1,0,0,1,0,1,2,50.0,1,3,1,2,3,4,1,0,Matches,2023
272,Joe Hart,eng ENG,GK,Celtic,35,1987,6.0,0,0,0,0,0,0,0,,0,0,0,0,1,1,1,1,Matches,2023
273,Makoto Hasebe,jp JPN,DF,Eint Frankfurt,38,1984,2.9,2,2,1,1,0,1,2,50.0,1,7,2,5,2,4,9,0,Matches,2023
274,Reo Hatate,jp JPN,MF,Celtic,24,1997,5.0,5,1,2,3,0,2,3,66.7,1,4,0,4,3,8,5,0,Matches,2023
275,Milan Havel,cz CZE,DF,Viktoria Plzeň,27,1994,4.7,12,5,6,3,3,7,8,87.5,1,6,0,6,4,16,12,0,Matches,2023
276,Kai Havertz,de GER,"FW,MF",Chelsea,23,1999,6.9,6,3,0,3,3,1,7,14.3,6,9,1,8,1,7,4,0,Matches,2023
277,Eden Hazard,be BEL,"FW,MF",Real Madrid,31,1991,1.5,0,0,0,0,0,0,1,0.0,1,1,0,1,1,1,0,0,Matches,2023
278,Thorgan Hazard,be BEL,"DF,FW",Dortmund,29,1993,2.2,3,1,1,2,0,3,6,50.0,3,3,1,2,3,6,3,0,Matches,2023
279,Dolev Haziz,il ISR,DF,Maccabi Haifa,27,1995,2.3,7,5,4,2,1,4,7,57.1,3,0,0,0,2,9,3,0,Matches,2023
280,Lukáš Hejda,cz CZE,DF,Viktoria Plzeň,32,1990,5.7,8,3,7,0,1,1,2,50.0,1,9,7,2,7,15,22,0,Matches,2023
281,Jordan Henderson,eng ENG,MF,Liverpool,32,1990,3.1,7,2,1,2,4,4,7,57.1,3,2,0,2,3,10,1,0,Matches,2023
282,Jack Hendry,sct SCO,DF,Club Brugge,27,1995,1.0,1,1,0,0,1,0,0,,0,0,0,0,0,1,4,0,Matches,2023
283,Benjamin Henrichs,de GER,"DF,MF",RB Leipzig,25,1997,2.2,5,2,3,2,0,5,9,55.6,4,2,1,1,3,8,4,0,Matches,2023
284,Mario Hermoso,es ESP,DF,Atlético Madrid,27,1995,1.8,1,1,0,0,1,1,3,33.3,2,2,1,1,2,3,9,0,Matches,2023
285,Lucas Hernández,fr FRA,DF,Bayern Munich,26,1996,1.9,3,2,3,0,0,2,3,66.7,1,3,2,1,8,11,2,0,Matches,2023
286,Theo Hernández,fr FRA,DF,Milan,24,1997,10.5,27,16,12,12,3,10,18,55.6,8,7,2,5,6,33,21,2,Matches,2023
287,Son Heung-min,kr KOR,"MF,FW",Tottenham,30,1992,6.9,10,4,5,2,3,2,8,25.0,6,2,0,2,1,11,3,0,Matches,2023
288,Piero Hincapié,ec ECU,DF,Leverkusen,20,2002,5.0,19,11,10,8,1,11,15,73.3,4,4,2,2,6,25,14,0,Matches,2023
289,Adam Hložek,cz CZE,"MF,FW",Leverkusen,20,2002,3.1,2,2,2,0,0,0,3,0.0,3,2,0,2,0,2,7,0,Matches,2023
290,Libor Holík,cz CZE,DF,Viktoria Plzeň,24,1998,3.2,5,1,3,2,0,4,8,50.0,4,2,0,2,4,9,10,0,Matches,2023
291,Lukáš Hrádecký,fi FIN,GK,Leverkusen,32,1989,6.0,0,0,0,0,0,0,0,,0,0,0,0,0,0,1,1,Matches,2023
292,Callum Hudson-Odoi,eng ENG,FW,Leverkusen,21,2000,5.1,2,1,1,0,1,2,4,50.0,2,0,0,0,3,5,1,0,Matches,2023
293,Mats Hummels,de GER,DF,Dortmund,33,1988,3.5,8,5,3,5,0,4,9,44.4,5,10,5,5,7,15,17,0,Matches,2023
294,Pierre Højbjerg,dk DEN,MF,Tottenham,26,1995,6.9,12,8,8,3,1,9,20,45.0,11,7,4,3,11,23,6,0,Matches,2023
295,Samuel Iling-Junior,eng ENG,DF,Juventus,18,2003,0.2,0,0,0,0,0,0,1,0.0,1,0,0,0,1,1,1,0,Matches,2023
296,Gonçalo Inácio,pt POR,DF,Sporting CP,20,2001,6.0,4,1,4,0,0,2,6,33.3,4,7,3,4,5,9,21,0,Matches,2023
297,Isco,es ESP,"MF,FW",Sevilla,30,1992,4.4,6,3,3,3,0,3,11,27.3,8,2,0,2,5,11,1,0,Matches,2023
298,Franco Israel,uy URU,GK,Sporting CP,22,2000,1.7,0,0,0,0,0,0,0,,0,0,0,0,0,0,0,1,Matches,2023
299,Luka Ivanušec,hr CRO,MF,Dinamo Zagreb,23,1998,5.8,7,2,1,6,0,3,7,42.9,4,3,1,2,6,13,1,0,Matches,2023
300,Ryan Jack,sct SCO,MF,Rangers,30,1992,2.1,4,3,2,2,0,2,2,100.0,0,1,1,0,1,5,1,1,Matches,2023
301,Kristijan Jakić,hr CRO,DF,Eint Frankfurt,25,1997,6.8,20,9,11,8,1,11,23,47.8,12,7,3,4,3,23,18,2,Matches,2023
302,Reece James,eng ENG,"DF,MF",Chelsea,22,1999,7.7,14,8,10,4,0,6,15,40.0,9,13,1,12,7,21,11,0,Matches,2023
303,Adnan Januzaj,be BEL,"FW,MF",Sevilla,27,1995,0.6,2,1,1,1,0,1,1,100.0,0,0,0,0,1,3,1,0,Matches,2023
304,Luis Javier Suárez,co COL,FW,Marseille,24,1997,1.3,1,0,0,1,0,1,1,100.0,0,2,0,2,0,1,1,0,Matches,2023
305,Elias Jelert,dk DEN,"DF,MF",FC Copenhagen,19,2003,2.1,4,2,2,2,0,1,4,25.0,3,0,0,0,1,5,1,0,Matches,2023
306,Václav Jemelka,cz CZE,DF,Viktoria Plzeň,27,1995,4.0,12,7,9,2,1,4,10,40.0,6,7,3,4,5,17,12,0,Matches,2023
307,Valdemar Jensen,dk DEN,DF,FC Copenhagen,19,2003,3.4,5,5,4,1,0,3,5,60.0,2,5,4,1,5,10,5,0,Matches,2023
308,Moritz Jenz,de GER,DF,Celtic,23,1999,6.0,8,4,5,3,0,4,8,50.0,4,16,11,5,8,16,15,1,Matches,2023
309,Juan Jesus,br BRA,DF,Napoli,31,1991,2.3,3,1,1,2,0,0,1,0.0,1,5,5,0,1,4,6,0,Matches,2023
310,Erik Jirka,sk SVK,"FW,MF",Viktoria Plzeň,24,1997,3.0,2,0,2,0,0,1,3,33.3,2,2,1,1,7,9,5,0,Matches,2023
311,Ísak Jóhannesson,is ISL,"FW,MF",FC Copenhagen,19,2003,3.2,4,0,2,1,1,3,4,75.0,1,5,0,5,2,6,3,0,Matches,2023
312,Curtis Jones,eng ENG,"FW,MF",Liverpool,21,2001,1.1,2,0,0,2,0,1,1,100.0,0,3,0,3,1,3,0,0,Matches,2023
313,Frenkie de Jong,nl NED,MF,Barcelona,25,1997,2.6,4,3,1,3,0,1,3,33.3,2,5,1,4,3,7,2,0,Matches,2023
314,Joan Jordán,es ESP,MF,Sevilla,28,1994,2.9,4,2,2,2,0,2,5,40.0,3,6,3,3,4,8,2,1,Matches,2023
315,Jorginho,it ITA,MF,Chelsea,30,1991,4.6,14,6,8,4,2,5,7,71.4,2,13,0,13,11,25,6,0,Matches,2023
316,Jota,pt POR,FW,Celtic,23,1999,3.2,1,0,0,1,0,0,3,0.0,3,3,0,3,3,4,0,0,Matches,2023
317,Diogo Jota,pt POR,"FW,MF",Liverpool,25,1996,2.9,3,2,2,1,0,1,2,50.0,1,2,0,2,0,3,1,0,Matches,2023
318,Vinicius Júnior,br BRA,FW,Real Madrid,22,2000,10.8,10,7,7,3,0,4,12,33.3,8,8,0,8,1,11,1,0,Matches,2023
319,Josip Juranović,hr CRO,DF,Celtic,26,1995,6.0,12,7,8,3,1,9,11,81.8,2,4,2,2,5,17,9,0,Matches,2023
320,Jutglà,es ESP,FW,Club Brugge,23,1999,5.7,2,1,0,2,0,0,1,0.0,1,3,0,3,0,2,2,0,Matches,2023
321,Issa Kaboré,bf BFA,DF,Marseille,21,2001,1.3,4,3,1,1,2,1,2,50.0,1,1,0,1,0,4,0,0,Matches,2023
322,Pierre Kalulu,fr FRA,DF,Milan,22,2000,8.3,15,8,11,4,0,4,9,44.4,5,12,6,6,7,22,17,0,Matches,2023
323,Lukáš Kalvach,cz CZE,MF,Viktoria Plzeň,27,1995,5.5,13,5,6,5,2,4,16,25.0,12,9,0,9,14,27,5,0,Matches,2023
324,Daichi Kamada,jp JPN,"MF,FW",Eint Frankfurt,25,1996,7.7,17,9,9,6,2,11,19,57.9,8,9,3,6,9,26,7,0,Matches,2023
325,Glen Kamara,fi FIN,MF,Rangers,26,1995,1.4,0,0,0,0,0,0,1,0.0,1,2,1,1,4,4,1,1,Matches,2023
326,Dijon Kameri,at AUT,MF,RB Salzburg,18,2004,1.3,4,2,0,3,1,4,6,66.7,2,1,0,1,1,5,0,0,Matches,2023
327,Kevin Kampl,si SVN,MF,RB Leipzig,31,1990,3.0,8,6,4,3,1,2,3,66.7,1,1,0,1,3,11,2,1,Matches,2023
328,Harry Kane,eng ENG,FW,Tottenham,29,1993,8.0,1,0,0,1,0,0,3,0.0,3,2,1,1,2,3,6,0,Matches,2023
329,N'Golo Kanté,fr FRA,MF,Chelsea,31,1991,1.8,3,2,0,0,3,2,4,50.0,2,2,0,2,2,5,0,0,Matches,2023
330,Mamoudou Karamoko,fr FRA,FW,FC Copenhagen,22,1999,0.5,0,0,0,0,0,0,0,,0,0,0,0,0,0,1,0,Matches,2023
331,Moise Kean,it ITA,"FW,MF",Juventus,22,2000,1.2,1,1,0,1,0,0,0,,0,1,0,1,0,1,0,0,Matches,2023
332,Ryan Kent,eng ENG,"FW,MF",Rangers,25,1996,5.6,6,3,3,1,2,1,3,33.3,2,4,0,4,1,7,0,0,Matches,2023
333,Franck Kessié,ci CIV,MF,Barcelona,25,1996,3.0,6,2,2,3,1,2,3,66.7,1,2,0,2,2,8,0,0,Matches,2023
334,Davit Khocholava,ge GEO,DF,FC Copenhagen,29,1993,4.8,2,1,2,0,0,2,3,66.7,1,4,3,1,10,12,21,0,Matches,2023
335,Joshua Kimmich,de GER,MF,Bayern Munich,27,1995,9.0,19,11,9,9,1,8,27,29.6,19,18,5,13,20,39,7,0,Matches,2023
336,Presnel Kimpembe,fr FRA,DF,Paris S-G,26,1995,1.6,2,2,1,1,0,0,0,,0,1,0,1,2,4,2,0,Matches,2023
337,Leon King,sct SCO,DF,Rangers,18,2004,4.2,10,5,8,1,1,3,11,27.3,8,5,2,3,5,15,12,0,Matches,2023
338,Simon Kjær,dk DEN,DF,Milan,33,1989,5.6,6,4,4,2,0,5,8,62.5,3,10,5,5,6,12,24,0,Matches,2023
339,Maurits Kjærgaard,dk DEN,MF,RB Salzburg,19,2003,5.5,21,11,6,10,5,9,18,50.0,9,10,2,8,4,25,2,0,Matches,2023
340,Davy Klaassen,nl NED,MF,Ajax,29,1993,2.4,0,0,0,0,0,0,4,0.0,4,1,0,1,0,0,2,0,Matches,2023
341,Jan Kliment,cz CZE,FW,Viktoria Plzeň,28,1993,0.5,0,0,0,0,0,0,1,0.0,1,0,0,0,0,0,1,0,Matches,2023
342,Lukas Klostermann,de GER,DF,RB Leipzig,26,1996,0.6,3,1,3,0,0,2,2,100.0,0,3,1,2,0,3,0,0,Matches,2023
343,Ansgar Knauff,de GER,"DF,FW",Eint Frankfurt,20,2002,3.3,9,6,7,2,0,0,6,0.0,6,3,1,2,6,15,1,0,Matches,2023
344,Gregor Kobel,ch SUI,GK,Dortmund,24,1997,3.5,0,0,0,0,0,0,0,,0,0,0,0,0,0,1,0,Matches,2023
345,Philipp Köhn,ch SUI,GK,RB Salzburg,24,1998,6.0,1,0,1,0,0,1,1,100.0,0,0,0,0,0,1,1,0,Matches,2023
346,Sekou Koita,ml MLI,FW,RB Salzburg,22,1999,0.2,0,0,0,0,0,0,0,,0,0,0,0,0,0,0,0,Matches,2023
347,Koke,es ESP,MF,Atlético Madrid,30,1992,3.7,2,1,1,1,0,0,3,0.0,3,2,1,1,1,3,0,0,Matches,2023
348,Sead Kolašinac,ba BIH,DF,Marseille,29,1993,1.7,5,3,3,2,0,3,4,75.0,1,1,0,1,1,6,3,0,Matches,2023
349,Randal Kolo Muani,fr FRA,FW,Eint Frankfurt,23,1998,5.7,4,4,1,2,1,0,0,,0,4,2,2,2,6,0,0,Matches,2023
350,Ibrahima Konaté,fr FRA,DF,Liverpool,23,1999,2.9,6,5,4,2,0,3,3,100.0,0,4,3,1,1,7,11,0,Matches,2023
351,Geoffrey Kondogbia,cf CTA,MF,Atlético Madrid,29,1993,2.5,8,4,1,6,1,5,5,100.0,0,4,0,4,7,15,2,0,Matches,2023
352,Yukhym Konoplia,ua UKR,DF,Shakhtar,22,1999,4.6,10,7,3,6,1,5,11,45.5,6,8,1,7,2,12,12,1,Matches,2023
353,Jan Kopic,cz CZE,"FW,MF",Viktoria Plzeň,32,1990,0.9,1,1,1,0,0,1,3,33.3,2,1,0,1,1,2,0,0,Matches,2023
354,Odilon Kossonou,ci CIV,DF,Leverkusen,21,2001,4.8,10,6,7,3,0,5,5,100.0,0,3,1,2,4,14,20,0,Matches,2023
355,Filip Kostić,rs SRB,"DF,FW",Juventus,29,1992,4.8,8,4,3,2,3,6,16,37.5,10,3,1,2,0,8,4,0,Matches,2023
356,Kalidou Koulibaly,sn SEN,DF,Chelsea,31,1991,6.3,12,7,9,2,1,7,11,63.6,4,17,6,11,8,20,21,0,Matches,2023
357,Jules Koundé,fr FRA,DF,Barcelona,23,1998,2.7,7,3,5,2,0,7,8,87.5,1,1,1,0,3,10,2,0,Matches,2023
358,Mateo Kovačić,hr CRO,MF,Chelsea,28,1994,6.9,11,5,3,7,1,8,16,50.0,8,8,1,7,6,17,2,0,Matches,2023
359,Adam Kronus,,FW,Viktoria Plzeň,20,2002,0.0,0,0,0,0,0,0,0,,0,0,0,0,0,0,0,0,Matches,2023
360,Toni Kroos,de GER,MF,Real Madrid,32,1990,9.4,26,16,11,12,3,11,18,61.1,7,7,2,5,9,35,2,0,Matches,2023
361,Rade Krunić,ba BIH,"MF,FW",Milan,28,1993,9.1,17,11,10,5,2,7,21,33.3,14,15,8,7,7,24,8,1,Matches,2023
362,Dmytro Kryskiv,ua UKR,MF,Shakhtar,21,2000,0.1,0,0,0,0,0,0,1,0.0,1,0,0,0,0,0,0,0,Matches,2023
363,Serhiy Kryvtsov,ua UKR,DF,Shakhtar,31,1991,0.1,0,0,0,0,0,0,0,,0,0,0,0,0,0,0,0,Matches,2023
364,Dejan Kulusevski,se SWE,"MF,DF",Tottenham,22,2000,2.2,5,3,0,4,1,2,4,50.0,2,4,0,4,1,6,0,0,Matches,2023
365,Khvicha Kvaratskhelia,ge GEO,FW,Napoli,21,2001,7.7,12,10,8,1,3,8,17,47.1,9,6,0,6,2,14,5,0,Matches,2023
366,Konrad Laimer,at AUT,"MF,FW",RB Leipzig,25,1997,2.9,10,6,4,4,2,3,12,25.0,9,4,0,4,2,12,2,0,Matches,2023
367,Érik Lamela,ar ARG,"FW,MF",Sevilla,30,1992,3.1,4,1,3,1,0,2,3,66.7,1,6,0,6,2,6,0,0,Matches,2023
368,Noa Lang,nl NED,FW,Club Brugge,23,1999,3.2,7,3,3,2,2,1,4,25.0,3,3,0,3,0,7,1,0,Matches,2023
369,Aymeric Laporte,es ESP,DF,Manchester City,28,1994,3.2,0,0,0,0,0,0,2,0.0,2,0,0,0,3,3,4,0,Matches,2023
370,Cyle Larin,ca CAN,"FW,MF",Club Brugge,27,1995,0.1,0,0,0,0,0,0,0,,0,0,0,0,0,0,0,0,Matches,2023
371,Rasmus Lauritsen,dk DEN,DF,Dinamo Zagreb,26,1996,0.2,0,0,0,0,0,0,0,,0,0,0,0,1,1,1,0,Matches,2023
372,Neta Lavi,il ISR,MF,Maccabi Haifa,25,1996,5.2,23,17,12,10,1,7,20,35.0,13,5,0,5,9,32,6,0,Matches,2023
373,Rafael Leão,pt POR,"FW,MF",Milan,23,1999,10.1,3,2,1,1,1,1,1,100.0,0,2,0,2,3,6,7,0,Matches,2023
374,Thomas Lemar,fr FRA,MF,Atlético Madrid,26,1995,1.2,1,1,0,0,1,0,1,0.0,1,2,0,2,1,2,0,0,Matches,2023
375,Clément Lenglet,fr FRA,DF,Tottenham,27,1995,5.6,15,8,7,7,1,6,8,75.0,2,6,3,3,7,22,16,0,Matches,2023
376,Christopher Lenz,de GER,DF,Eint Frankfurt,27,1994,2.5,6,2,3,3,0,4,6,66.7,2,4,0,4,4,10,4,0,Matches,2023
377,Lukas Lerager,dk DEN,MF,FC Copenhagen,29,1993,5.0,8,4,4,3,1,3,9,33.3,6,6,0,6,14,22,5,0,Matches,2023
378,Robert Lewandowski,pl POL,FW,Barcelona,33,1988,4.9,5,4,0,1,4,1,1,100.0,0,3,0,3,1,6,6,0,Matches,2023
379,Rico Lewis,eng ENG,DF,Manchester City,17,2004,1.3,1,1,0,1,0,0,0,,0,2,1,1,0,1,0,0,Matches,2023
380,Matthijs de Ligt,nl NED,DF,Bayern Munich,22,1999,6.8,5,3,2,3,0,1,3,33.3,2,6,4,2,10,15,21,0,Matches,2023
381,Jesper Lindstrøm,dk DEN,"MF,FW",Eint Frankfurt,22,2000,5.6,4,2,3,1,0,1,5,20.0,4,11,0,11,2,6,1,0,Matches,2023
382,Dominik Livaković,hr CRO,GK,Dinamo Zagreb,27,1995,6.0,0,0,0,0,0,0,0,,0,0,0,0,0,0,4,0,Matches,2023
383,Robert Ljubicic,at AUT,"FW,DF",Dinamo Zagreb,23,1999,6.0,13,6,7,4,2,7,18,38.9,11,10,1,9,10,23,7,0,Matches,2023
384,Marcos Llorente,es ESP,"MF,FW",Atlético Madrid,27,1995,2.4,2,1,1,1,0,1,1,100.0,0,3,0,3,2,4,3,0,Matches,2023
385,Hugo Lloris,fr FRA,GK,Tottenham,35,1986,6.0,0,0,0,0,0,0,0,,0,0,0,0,1,1,2,0,Matches,2023
386,Danny Loader,eng ENG,"FW,MF",Porto,21,2000,0.6,2,2,1,1,0,1,1,100.0,0,0,0,0,0,2,0,0,Matches,2023
387,Stanislav Lobotka,sk SVK,MF,Napoli,27,1994,9.7,21,11,7,10,4,11,20,55.0,9,7,2,5,5,26,3,1,Matches,2023
388,Manuel Locatelli,it ITA,MF,Juventus,24,1998,2.5,9,5,2,3,4,4,6,66.7,2,6,0,6,2,11,2,0,Matches,2023
389,Ruben Loftus-Cheek,eng ENG,MF,Chelsea,26,1996,3.2,7,4,0,6,1,2,3,66.7,1,5,2,3,7,14,3,0,Matches,2023
390,Pau López,es ESP,GK,Marseille,27,1994,6.0,0,0,0,0,0,0,0,,0,0,0,0,0,0,1,0,Matches,2023
391,Alexander lowry,sct SCO,MF,Rangers,19,2003,0.1,0,0,0,0,0,0,0,,0,0,0,0,0,0,0,0,Matches,2023
392,Hirving Lozano,mx MEX,FW,Napoli,27,1995,5.2,10,6,4,1,5,5,11,45.5,6,7,0,7,2,12,3,0,Matches,2023
393,Florentino Luís,pt POR,MF,Benfica,22,1999,9.5,26,15,8,18,0,9,31,29.0,22,11,1,10,27,53,15,0,Matches,2023
394,Romelu Lukaku,be BEL,FW,Inter,29,1993,2.1,3,3,0,1,2,1,1,100.0,0,1,0,1,0,3,3,0,Matches,2023
395,John Lundstram,eng ENG,"MF,DF",Rangers,28,1994,5.0,6,3,2,4,0,5,15,33.3,10,4,1,3,9,15,12,0,Matches,2023
396,Andriy Lunin,ua UKR,GK,Real Madrid,23,1999,2.0,0,0,0,0,0,0,0,,0,0,0,0,0,0,1,0,Matches,2023
397,Mahir Madatov,az AZE,FW,Dinamo Zagreb,25,1997,0.2,0,0,0,0,0,0,0,,0,0,0,0,0,0,1,0,Matches,2023
398,Daizen Maeda,jp JPN,FW,Celtic,24,1997,3.7,7,3,0,5,2,1,4,25.0,3,9,2,7,7,14,1,0,Matches,2023
399,Riyad Mahrez,dz ALG,"FW,MF",Manchester City,31,1991,5.6,9,5,1,3,5,5,9,55.6,4,1,0,1,1,10,1,0,Matches,2023
400,Mike Maignan,fr FRA,GK,Milan,27,1995,7.0,0,0,0,0,0,0,0,,0,0,0,0,0,0,3,0,Matches,2023
401,Donyell Malen,nl NED,"FW,MF",Dortmund,23,1999,2.8,1,0,1,0,0,0,0,,0,3,0,3,2,3,1,0,Matches,2023
402,Reinildo Mandava,mz MOZ,DF,Atlético Madrid,28,1994,5.7,11,8,9,2,0,9,10,90.0,1,8,1,7,5,16,7,0,Matches,2023
403,Sadio Mané,sn SEN,FW,Bayern Munich,30,1992,6.1,10,6,1,4,5,4,5,80.0,1,10,1,9,4,14,2,0,Matches,2023
404,Iván Marcano,es ESP,DF,Porto,35,1987,3.0,2,1,2,0,0,1,4,25.0,3,6,4,2,4,6,12,0,Matches,2023
405,Marcão,br BRA,DF,Sevilla,26,1996,2.5,7,5,3,4,0,5,6,83.3,1,7,2,5,1,8,9,0,Matches,2023
406,José María Giménez,uy URU,DF,Atlético Madrid,27,1995,4.5,6,3,4,2,0,4,7,57.1,3,3,2,1,6,12,20,0,Matches,2023
407,Mariano,do DOM,FW,Real Madrid,28,1993,0.1,0,0,0,0,0,0,0,,0,0,0,0,0,0,0,0,Matches,2023
408,Antonio Marin,hr CRO,FW,Dinamo Zagreb,21,2001,0.1,0,0,0,0,0,0,0,,0,0,0,0,0,0,0,0,Matches,2023
409,João Mário,pt POR,FW,Benfica,29,1993,9.6,12,8,2,6,4,6,17,35.3,11,7,0,7,5,17,8,0,Matches,2023
410,João Mário Lopes,pt POR,DF,Porto,22,2000,3.0,8,4,2,4,2,4,7,57.1,3,4,2,2,3,11,5,1,Matches,2023
411,Marquinhos,br BRA,DF,Paris S-G,28,1994,7.3,5,3,2,3,0,4,7,57.1,3,7,4,3,3,8,20,0,Matches,2023
412,José Marsà,es ESP,DF,Sporting CP,20,2002,1.1,1,0,1,0,0,0,1,0.0,1,1,0,1,1,2,6,0,Matches,2023
413,Lautaro Martínez,ar ARG,FW,Inter,24,1997,11.1,16,12,4,5,7,6,14,42.9,8,12,1,11,9,25,8,0,Matches,2023
414,Toni Martínez,es ESP,FW,Porto,25,1997,1.3,7,4,1,4,2,2,2,100.0,0,1,0,1,0,7,0,0,Matches,2023
415,Clinton Mata,ao ANG,DF,Club Brugge,29,1992,1.8,1,1,1,0,0,1,4,25.0,3,2,0,2,4,5,2,1,Matches,2023
416,Pape Matar Sarr,sn SEN,MF,Tottenham,19,2002,1.0,5,3,3,1,1,2,3,66.7,1,1,0,1,1,6,0,0,Matches,2023
417,Joël Matip,cm CMR,DF,Liverpool,30,1991,2.7,8,3,4,4,0,5,6,83.3,1,0,0,0,3,11,3,0,Matches,2023
418,Rabbi Matondo,wls WAL,"MF,FW",Rangers,21,2000,1.1,1,1,1,0,0,0,1,0.0,1,1,0,1,2,3,0,0,Matches,2023
419,Mykola Matviyenko,ua UKR,DF,Shakhtar,26,1996,6.0,10,4,9,1,0,6,9,66.7,3,13,4,9,9,19,35,0,Matches,2023
420,Philipp Max,de GER,DF,Eint Frankfurt,28,1993,1.3,1,1,0,0,1,1,4,25.0,3,3,0,3,1,2,1,0,Matches,2023
421,Eric Maxim Choupo-Moting,cm CMR,FW,Bayern Munich,33,1989,4.8,7,4,3,3,1,0,1,0.0,1,6,0,6,1,8,2,0,Matches,2023
422,Noussair Mazraoui,ma MAR,DF,Bayern Munich,24,1997,4.4,13,9,8,4,1,7,11,63.6,4,3,1,2,3,16,11,0,Matches,2023
423,Kylian Mbappé,fr FRA,FW,Paris S-G,23,1998,7.2,0,0,0,0,0,0,1,0.0,1,0,0,0,0,0,3,0,Matches,2023
424,Chancel Mbemba,cd COD,DF,Marseille,27,1994,4.5,14,6,10,2,2,5,5,100.0,0,4,1,3,4,18,6,0,Matches,2023
425,James McCarthy,ie IRL,MF,Celtic,31,1990,0.1,0,0,0,0,0,0,0,,0,0,0,0,0,0,1,0,Matches,2023
426,Allan McGregor,sct SCO,GK,Rangers,40,1982,5.0,0,0,0,0,0,0,0,,0,0,0,0,0,0,2,0,Matches,2023
427,Callum McGregor,sct SCO,MF,Celtic,29,1993,2.4,3,1,2,1,0,2,5,40.0,3,2,0,2,5,8,4,0,Matches,2023
428,Weston McKennie,us USA,MF,Juventus,23,1998,4.0,6,3,2,2,2,4,7,57.1,3,10,2,8,5,11,3,0,Matches,2023
429,Jon McLaughlin,sct SCO,GK,Rangers,34,1987,1.0,0,0,0,0,0,0,1,0.0,1,0,0,0,0,0,0,0,Matches,2023
430,Brandon Mechele,be BEL,DF,Club Brugge,29,1993,8.0,11,7,6,5,0,3,9,33.3,6,7,5,2,11,22,38,0,Matches,2023
431,Bjorn Meijer,nl NED,DF,Club Brugge,19,2003,6.4,9,9,5,3,1,4,10,40.0,6,11,4,7,11,20,11,1,Matches,2023
432,Raz Meir,il ISR,"DF,MF",Maccabi Haifa,25,1996,0.9,4,3,2,1,1,3,3,100.0,0,1,0,1,0,4,0,0,Matches,2023
433,Arthur Melo,br BRA,MF,Liverpool,25,1996,0.2,1,0,1,0,0,1,1,100.0,0,0,0,0,0,1,0,0,Matches,2023
434,Memphis,nl NED,FW,Barcelona,28,1994,0.2,0,0,0,0,0,0,0,,0,0,0,0,0,0,0,0,Matches,2023
435,Sun Menachem,il ISR,DF,Maccabi Haifa,28,1993,0.7,3,3,3,0,0,2,3,66.7,1,0,0,0,0,3,2,0,Matches,2023
436,Nuno Mendes,pt POR,"DF,MF",Paris S-G,20,2002,4.9,11,7,6,4,1,8,18,44.4,10,13,1,12,1,12,7,0,Matches,2023
437,Edouard Mendy,sn SEN,GK,Chelsea,30,1992,1.0,0,0,0,0,0,0,0,,0,0,0,0,0,0,0,0,Matches,2023
438,Ferland Mendy,fr FRA,DF,Real Madrid,27,1995,3.9,3,2,2,0,1,3,3,100.0,0,1,0,1,3,6,4,0,Matches,2023
439,Alex Meret,it ITA,GK,Napoli,25,1997,10.0,0,0,0,0,0,0,0,,0,0,0,0,0,0,3,1,Matches,2023
440,Lionel Messi,ar ARG,"FW,MF",Paris S-G,35,1987,6.8,4,4,1,2,1,0,3,0.0,3,3,0,3,3,7,0,0,Matches,2023
441,Junior Messias,br BRA,"FW,DF",Milan,31,1991,3.5,8,3,1,2,5,2,6,33.3,4,3,0,3,3,11,1,1,Matches,2023
442,Thomas Meunier,be BEL,DF,Dortmund,30,1991,3.9,13,7,8,4,1,7,10,70.0,3,6,1,5,6,19,10,0,Matches,2023
443,Alexander Meyer,de GER,GK,Dortmund,31,1991,4.5,0,0,0,0,0,0,0,,0,0,0,0,0,0,0,0,Matches,2023
444,Simon Mignolet,be BEL,GK,Club Brugge,34,1988,8.0,0,0,0,0,0,0,0,,0,0,0,0,1,1,5,0,Matches,2023
445,Arkadiusz Milik,pl POL,FW,Juventus,28,1994,3.8,2,1,0,1,1,1,3,33.3,2,2,0,2,1,3,0,0,Matches,2023
446,Éder Militão,br BRA,DF,Real Madrid,24,1998,8.3,10,5,7,3,0,8,13,61.5,5,11,7,4,9,19,37,0,Matches,2023
447,James Milner,eng ENG,MF,Liverpool,36,1986,2.7,11,9,6,4,1,3,4,75.0,1,5,1,4,2,13,2,0,Matches,2023
448,Kim Min-jae,kr KOR,DF,Napoli,25,1996,8.7,12,9,11,0,1,6,6,100.0,0,9,8,1,22,34,32,0,Matches,2023
449,Rafa Mir,es ESP,"MF,FW",Sevilla,25,1997,1.7,0,0,0,0,0,0,0,,0,1,0,1,0,0,5,0,Matches,2023
450,Fabio Miretti,it ITA,"MF,FW",Juventus,18,2003,2.4,3,2,2,1,0,2,2,100.0,0,1,1,0,0,3,0,0,Matches,2023
451,Josip Mišić,hr CRO,MF,Dinamo Zagreb,28,1994,5.8,11,6,6,5,0,7,11,63.6,4,13,5,8,8,19,8,0,Matches,2023
452,Henrikh Mkhitaryan,am ARM,MF,Inter,33,1989,10.1,26,17,15,9,2,12,29,41.4,17,12,2,10,16,42,11,0,Matches,2023
453,Anthony Modeste,fr FRA,FW,Dortmund,34,1988,3.8,2,0,2,0,0,0,2,0.0,2,5,2,3,0,2,6,0,Matches,2023
454,Luka Modrić,hr CRO,MF,Real Madrid,36,1985,8.3,4,2,2,1,1,2,5,40.0,3,2,1,1,7,11,7,0,Matches,2023
455,Ali Mohamed,ne NIG,MF,Maccabi Haifa,26,1995,4.0,11,2,7,2,2,3,11,27.3,8,1,0,1,7,18,3,0,Matches,2023
456,Kudus Mohammed,gh GHA,FW,Ajax,21,2000,5.0,4,2,1,3,0,2,4,50.0,2,3,0,3,5,9,3,0,Matches,2023
457,Sadegh Moharrami,ir IRN,"FW,DF",Dinamo Zagreb,26,1996,4.5,9,3,6,1,2,3,6,50.0,3,4,1,3,0,9,2,0,Matches,2023
458,Nahuel Molina,ar ARG,"DF,MF",Atlético Madrid,24,1998,5.2,7,3,3,1,3,4,9,44.4,5,2,1,1,1,8,4,0,Matches,2023
459,Gonzalo Montiel,ar ARG,DF,Sevilla,25,1997,2.5,5,5,0,5,0,3,5,60.0,2,2,0,2,4,9,6,1,Matches,2023
460,Aaron Mooy,au AUS,MF,Celtic,31,1990,1.7,0,0,0,0,0,0,1,0.0,1,0,0,0,1,1,3,0,Matches,2023
461,Álvaro Morata,es ESP,FW,Atlético Madrid,29,1992,3.3,0,0,0,0,0,0,0,,0,1,0,1,0,0,3,0,Matches,2023
462,Morato,br BRA,DF,Benfica,21,2001,1.2,0,0,0,0,0,0,1,0.0,1,4,3,1,1,1,3,0,Matches,2023
463,Alfredo Morelos,co COL,FW,Rangers,26,1996,2.8,1,1,0,1,0,0,3,0.0,3,4,0,4,1,2,3,0,Matches,2023
464,Hidemasa Morita,jp JPN,MF,Sporting CP,27,1995,3.7,5,1,3,1,1,1,1,100.0,0,3,1,2,2,7,3,0,Matches,2023
465,Jhon Mosquera,co COL,"FW,MF",Viktoria Plzeň,32,1990,4.8,12,6,4,6,2,3,4,75.0,1,3,2,1,4,16,8,0,Matches,2023
466,Youssoufa Moukoko,de GER,"FW,MF",Dortmund,17,2004,2.7,2,1,1,0,1,0,0,,0,0,0,0,0,2,0,0,Matches,2023
467,Mason Mount,eng ENG,MF,Chelsea,23,1999,4.9,13,6,4,6,3,5,12,41.7,7,7,1,6,4,17,2,0,Matches,2023
468,Lucas Moura,br BRA,"FW,MF",Tottenham,29,1992,1.9,3,2,1,1,1,1,1,100.0,0,2,0,2,0,3,0,0,Matches,2023
469,Mykhailo Mudryk,ua UKR,"FW,DF",Chelsea,21,2001,1.0,1,1,0,1,0,1,4,25.0,3,0,0,0,1,2,1,0,Matches,2023
470,Mykhailo Mudryk,ua UKR,MF,Shakhtar,21,2001,5.7,6,1,4,2,0,3,6,50.0,3,2,0,2,0,6,1,0,Matches,2023
471,Paul Mukairu,ng NGA,FW,FC Copenhagen,22,2000,0.5,2,2,1,1,0,2,2,100.0,0,0,0,0,0,2,0,0,Matches,2023
472,Nordi Mukiele,fr FRA,"DF,MF",Paris S-G,24,1997,1.2,1,1,0,1,0,1,1,100.0,0,3,1,2,1,2,2,0,Matches,2023
473,Thomas Müller,de GER,"MF,FW",Bayern Munich,32,1989,4.1,4,3,1,2,1,1,6,16.7,5,8,2,6,2,6,2,0,Matches,2023
474,Petar Musa,hr CRO,FW,Benfica,24,1998,1.4,0,0,0,0,0,0,0,,0,3,1,2,1,1,0,0,Matches,2023
475,Jamal Musiala,de GER,"MF,FW",Bayern Munich,19,2003,5.9,4,3,1,2,1,0,7,0.0,7,6,0,6,6,10,1,0,Matches,2023
476,Bohdan Mykhaylychenko,ua UKR,DF,Shakhtar,25,1997,4.0,7,2,5,2,0,5,7,71.4,2,3,0,3,7,14,16,0,Matches,2023
477,Obite N'Dicka,ci CIV,DF,Eint Frankfurt,22,1999,8.0,13,7,8,5,0,4,11,36.4,7,9,3,6,13,26,28,0,Matches,2023
478,Nacho,es ESP,DF,Real Madrid,32,1990,4.9,9,5,5,4,0,4,12,33.3,8,5,4,1,17,26,16,0,Matches,2023
479,Jesús Navas,es ESP,"DF,MF",Sevilla,36,1985,2.5,2,1,2,0,0,1,2,50.0,1,5,1,4,5,7,5,0,Matches,2023
480,Flávio Nazinho,pt POR,"DF,MF",Sporting CP,19,2003,1.3,3,2,3,0,0,0,2,0.0,2,0,0,0,1,4,3,0,Matches,2023
481,Tanguy Ndombele,fr FRA,MF,Napoli,25,1996,4.1,8,1,4,4,0,3,5,60.0,2,6,1,5,5,13,1,0,Matches,2023
482,David Neres,br BRA,"FW,MF",Benfica,25,1997,4.9,11,7,3,5,3,2,6,33.3,4,11,2,9,1,12,1,0,Matches,2023
483,Luís Neto,pt POR,DF,Sporting CP,34,1988,0.4,1,1,0,1,0,0,0,,0,1,1,0,0,1,2,0,Matches,2023
484,Manuel Neuer,de GER,GK,Bayern Munich,36,1986,3.0,0,0,0,0,0,0,0,,0,0,0,0,0,0,0,0,Matches,2023
485,João Neves,pt POR,"FW,MF",Benfica,17,2004,0.3,1,1,0,1,0,0,1,0.0,1,0,0,0,0,1,1,0,Matches,2023
486,Neymar,br BRA,"MF,FW",Paris S-G,30,1992,6.0,3,1,1,0,2,2,8,25.0,6,1,0,1,2,5,2,0,Matches,2023
487,Tanguy Nianzou,fr FRA,DF,Sevilla,20,2002,2.0,2,1,1,1,0,0,1,0.0,1,0,0,0,2,4,5,0,Matches,2023
488,Casper Nielsen,dk DEN,MF,Club Brugge,28,1994,7.2,19,14,7,9,3,7,15,46.7,8,10,5,5,6,25,8,0,Matches,2023
489,Saúl Ñíguez,es ESP,"MF,DF",Atlético Madrid,27,1994,3.1,10,6,3,5,2,5,6,83.3,1,7,0,7,4,14,5,0,Matches,2023
490,Christopher Nkunku,fr FRA,"MF,FW",RB Leipzig,24,1997,6.2,6,4,3,2,1,0,2,0.0,2,1,0,1,4,10,3,0,Matches,2023
491,Hugo Novoa,es ESP,MF,RB Leipzig,19,2003,0.0,0,0,0,0,0,0,0,,0,0,0,0,0,0,0,0,Matches,2023
492,Darwin Núñez,uy URU,FW,Liverpool,23,1999,4.4,3,3,2,1,0,0,1,0.0,1,5,0,5,1,4,1,0,Matches,2023
493,Antonio Nusa,no NOR,FW,Club Brugge,17,2005,0.6,0,0,0,0,0,0,0,,0,1,0,1,0,0,2,0,Matches,2023
494,Matt O'Riley,dk DEN,MF,Celtic,21,2000,5.3,18,7,4,10,4,4,13,30.8,9,9,2,7,11,29,4,0,Matches,2023
495,Jan Oblak,si SVN,GK,Atlético Madrid,29,1993,5.0,0,0,0,0,0,0,0,,0,0,0,0,0,0,2,0,Matches,2023
496,Lucas Ocampos,ar ARG,FW,Ajax,28,1994,0.2,0,0,0,0,0,0,0,,0,0,0,0,1,1,1,1,Matches,2023
497,Oleh Ocheretko,ua UKR,MF,Shakhtar,19,2003,0.2,2,2,0,1,1,0,1,0.0,1,0,0,0,0,2,0,0,Matches,2023
498,Denis Odoi,gh GHA,"DF,MF",Club Brugge,34,1988,5.8,11,2,6,4,1,7,9,77.8,2,11,5,6,7,18,18,0,Matches,2023
499,Noah Okafor,ch SUI,FW,RB Salzburg,22,2000,5.2,4,0,0,3,1,3,4,75.0,1,4,0,4,0,4,0,0,Matches,2023
500,Mathías Olivera,uy URU,DF,Napoli,24,1997,5.7,16,13,11,5,0,7,11,63.6,4,5,0,5,5,21,14,0,Matches,2023
501,Dani Olmo,es ESP,"FW,MF",RB Leipzig,24,1998,0.7,4,2,4,0,0,2,3,66.7,1,0,0,0,0,4,0,0,Matches,2023
502,André Onana,cm CMR,GK,Inter,26,1996,13.0,0,0,0,0,0,0,0,,0,0,0,0,0,0,2,0,Matches,2023
503,Raphael Onyedika,ng NGA,MF,Club Brugge,21,2001,6.3,9,5,3,5,1,5,12,41.7,7,7,2,5,6,15,14,0,Matches,2023
504,Willi Orban,hu HUN,DF,RB Leipzig,29,1992,8.0,9,5,5,2,2,7,10,70.0,3,12,7,5,8,17,26,0,Matches,2023
505,Divock Origi,be BEL,FW,Milan,27,1995,1.7,0,0,0,0,0,0,1,0.0,1,2,1,1,0,0,3,0,Matches,2023
506,Mislav Oršić,hr CRO,FW,Dinamo Zagreb,29,1992,5.4,5,4,1,4,0,2,6,33.3,4,1,0,1,2,7,0,0,Matches,2023
507,Stefan Ortega,de GER,GK,Manchester City,29,1992,2.0,0,0,0,0,0,0,0,,0,0,0,0,0,0,0,1,Matches,2023
508,Victor Osimhen,ng NGA,FW,Napoli,23,1998,4.7,5,2,0,2,3,4,5,80.0,1,0,0,0,1,6,7,0,Matches,2023
509,Nicolás Otamendi,ar ARG,DF,Benfica,34,1988,8.8,17,11,15,2,0,9,17,52.9,8,15,5,10,15,32,32,0,Matches,2023
510,Otávio,pt POR,MF,Porto,27,1995,5.8,17,13,8,8,1,6,16,37.5,10,10,0,10,1,18,2,0,Matches,2023
511,Alex Oxlade-Chamberlain,eng ENG,MF,Liverpool,28,1993,0.2,1,1,0,0,1,1,1,100.0,0,0,0,0,1,2,0,0,Matches,2023
512,Salih Özcan,tr TUR,MF,Dortmund,24,1998,6.0,8,4,3,5,0,4,15,26.7,11,6,0,6,12,20,7,0,Matches,2023
513,Exequiel Palacios,ar ARG,MF,Leverkusen,23,1998,1.0,3,1,0,2,1,1,2,50.0,1,4,0,4,1,4,2,1,Matches,2023
514,Cole Palmer,eng ENG,"MF,FW",Manchester City,20,2002,1.5,1,0,0,1,0,1,1,100.0,0,3,0,3,0,1,0,0,Matches,2023
515,Antonios Papadopoulos,de GER,"MF,FW",Dortmund,22,1999,0.1,0,0,0,0,0,0,0,,0,0,0,0,0,0,0,0,Matches,2023
516,Leandro Paredes,ar ARG,MF,Juventus,28,1994,3.9,10,3,6,3,1,6,10,60.0,4,7,4,3,3,13,0,0,Matches,2023
517,Felix Passlack,de GER,DF,Dortmund,24,1998,1.0,3,1,1,1,1,2,2,100.0,0,2,0,2,0,3,2,0,Matches,2023
518,Remko Pasveer,nl NED,GK,Ajax,38,1983,6.0,0,0,0,0,0,0,0,,0,0,0,0,0,0,5,2,Matches,2023
519,Paulinho,pt POR,FW,Sporting CP,29,1992,2.6,3,2,1,2,0,0,1,0.0,1,2,0,2,0,3,6,0,Matches,2023
520,Paulinho,br BRA,FW,Leverkusen,22,2000,0.5,2,2,1,1,0,1,1,100.0,0,0,0,0,0,2,0,0,Matches,2023
521,Benjamin Pavard,fr FRA,DF,Bayern Munich,26,1996,6.6,12,9,8,3,1,4,8,50.0,4,10,5,5,13,25,20,0,Matches,2023
522,Strahinja Pavlović,rs SRB,DF,RB Salzburg,21,2001,6.0,17,8,12,5,0,6,8,75.0,2,7,7,0,3,20,29,1,Matches,2023
523,Dimitri Payet,fr FRA,MF,Marseille,35,1987,0.9,1,1,0,0,1,1,2,50.0,1,0,0,0,1,2,0,0,Matches,2023
524,Pedri,es ESP,"MF,FW",Barcelona,19,2002,4.5,7,2,2,5,0,2,8,25.0,6,7,0,7,5,12,1,1,Matches,2023
525,Luca Pellegrini,it ITA,"DF,MF",Eint Frankfurt,23,1999,2.2,7,3,1,5,1,4,7,57.1,3,4,0,4,3,10,5,0,Matches,2023
526,Iñaki Peña ,es ESP,GK,Barcelona,23,1999,1.0,0,0,0,0,0,0,0,,0,0,0,0,0,0,0,0,Matches,2023
527,Pepe,pt POR,DF,Porto,39,1983,4.0,7,4,7,0,0,5,6,83.3,1,3,3,0,6,13,15,0,Matches,2023
528,Pepê,br BRA,"DF,FW",Porto,25,1997,7.6,14,9,13,1,0,6,15,40.0,9,5,2,3,5,19,10,0,Matches,2023
529,Danilo Pereira,pt POR,"DF,MF",Paris S-G,30,1991,5.0,10,7,7,3,0,7,8,87.5,1,3,2,1,6,16,12,0,Matches,2023
530,Dino Perić,hr CRO,DF,Dinamo Zagreb,28,1994,6.0,8,4,7,1,0,5,5,100.0,0,10,7,3,14,22,54,1,Matches,2023
531,Mattia Perin,it ITA,GK,Juventus,29,1992,2.0,0,0,0,0,0,0,0,,0,0,0,0,0,0,0,0,Matches,2023
532,Ivan Perišić,hr CRO,"DF,MF",Tottenham,33,1989,6.4,19,7,8,9,2,10,20,50.0,10,8,5,3,4,23,18,1,Matches,2023
533,Luděk Pernica,cz CZE,DF,Viktoria Plzeň,32,1990,5.5,6,4,5,1,0,5,10,50.0,5,6,4,2,3,9,20,0,Matches,2023
534,Bruno Petković,hr CRO,FW,Dinamo Zagreb,27,1994,5.4,8,5,2,5,1,3,12,25.0,9,2,0,2,2,10,6,0,Matches,2023
535,Ivan Petryak,ua UKR,MF,Shakhtar,28,1994,2.0,2,2,0,2,0,0,0,,0,3,0,3,0,2,1,0,Matches,2023
536,Kalvin Phillips,eng ENG,MF,Manchester City,26,1995,0.5,0,0,0,0,0,0,0,,0,1,0,1,1,1,0,0,Matches,2023
537,Frantzdy Pierrot,ht HAI,FW,Maccabi Haifa,27,1995,5.3,3,1,1,1,1,0,1,0.0,1,3,1,2,1,4,8,0,Matches,2023
538,Václav Pilař,cz CZE,"FW,MF",Viktoria Plzeň,33,1988,1.4,2,1,0,1,1,1,3,33.3,2,0,0,0,0,2,1,0,Matches,2023
539,Rodrigo Pinho,br BRA,FW,Benfica,31,1991,0.2,0,0,0,0,0,0,1,0.0,1,0,0,0,0,0,1,0,Matches,2023
540,Gerard Piqué,es ESP,DF,Barcelona,35,1987,2.9,3,2,0,3,0,1,2,50.0,1,3,2,1,3,6,8,0,Matches,2023
541,Tommaso Pobega,it ITA,MF,Milan,23,1999,1.8,5,2,1,3,1,2,6,33.3,4,3,0,3,0,5,1,0,Matches,2023
542,Suf Podgoreanu,il ISR,DF,Maccabi Haifa,20,2002,0.1,0,0,0,0,0,0,0,,0,0,0,0,0,0,0,0,Matches,2023
543,Matteo Politano,it ITA,FW,Napoli,28,1993,4.5,9,6,2,5,2,4,5,80.0,1,3,0,3,1,10,6,0,Matches,2023
544,Pedro Porro,es ESP,"DF,MF",Sporting CP,22,1999,4.4,14,10,9,3,2,11,14,78.6,3,7,1,6,4,18,12,0,Matches,2023
545,Pedro Porro,es ESP,DF,Tottenham,22,1999,0.4,1,0,1,0,0,0,2,0.0,2,2,1,1,0,1,0,0,Matches,2023
546,Yussuf Poulsen,dk DEN,"FW,MF",RB Leipzig,28,1994,0.8,1,0,0,1,0,1,3,33.3,2,3,0,3,0,1,1,0,Matches,2023
547,Christian Pulisic,us USA,"DF,FW",Chelsea,23,1998,1.3,2,1,0,1,1,1,2,50.0,1,2,0,2,2,4,0,0,Matches,2023
548,Adrien Rabiot,fr FRA,MF,Juventus,27,1995,5.0,16,8,7,7,2,6,8,75.0,2,9,2,7,5,21,3,0,Matches,2023
549,Ivan Rakitić,hr CRO,MF,Sevilla,34,1988,4.6,9,4,2,4,3,2,8,25.0,6,5,2,3,4,13,3,0,Matches,2023
550,Gonçalo Ramos,pt POR,FW,Benfica,21,2001,7.9,11,5,0,7,4,0,5,0.0,5,5,1,4,1,12,10,0,Matches,2023
551,Sergio Ramos,es ESP,DF,Paris S-G,36,1986,8.0,9,5,3,6,0,7,11,63.6,4,11,6,5,11,20,25,0,Matches,2023
552,Calvin Ramsay,sct SCO,DF,Liverpool,19,2003,0.0,0,0,0,0,0,0,0,,0,0,0,0,0,0,1,0,Matches,2023
553,Raphinha,br BRA,FW,Barcelona,25,1996,3.3,8,7,3,3,2,2,6,33.3,4,4,1,3,4,12,3,0,Matches,2023
554,Giacomo Raspadori,it ITA,FW,Napoli,22,2000,2.8,4,3,0,3,1,0,1,0.0,1,1,0,1,2,6,1,0,Matches,2023
555,David Raum,de GER,DF,RB Leipzig,24,1998,5.9,13,7,8,4,1,10,22,45.5,12,7,1,6,7,20,15,0,Matches,2023
556,Ante Rebić,hr CRO,"FW,MF",Milan,28,1993,2.8,7,3,2,3,2,2,6,33.3,4,2,0,2,1,8,0,0,Matches,2023
557,Matheus Reis,br BRA,DF,Sporting CP,27,1995,5.7,10,7,5,5,0,6,7,85.7,1,4,2,2,3,13,17,0,Matches,2023
558,Karim Rekik,nl NED,DF,Sevilla,27,1994,1.0,0,0,0,0,0,0,0,,0,0,0,0,0,0,0,0,Matches,2023
559,Devyne Rensch,nl NED,DF,Ajax,19,2003,3.2,14,9,8,6,0,11,14,78.6,3,4,0,4,4,18,10,0,Matches,2023
560,Marco Reus,de GER,"MF,FW",Dortmund,33,1989,2.9,4,2,1,1,2,1,4,25.0,3,4,1,3,3,7,1,0,Matches,2023
561,Gio Reyna,us USA,"FW,MF",Dortmund,19,2002,4.3,3,2,0,2,1,1,5,20.0,4,2,0,2,3,6,2,1,Matches,2023
562,Richarlison,br BRA,"MF,FW",Tottenham,25,1997,4.1,3,1,1,2,0,3,5,60.0,2,4,2,2,2,5,0,0,Matches,2023
563,Stefan Ristovski,mk MKD,DF,Dinamo Zagreb,30,1992,4.1,6,2,4,1,1,2,6,33.3,4,7,4,3,6,12,8,0,Matches,2023
564,Mats Rits,be BEL,MF,Club Brugge,29,1993,0.2,1,1,1,0,0,1,1,100.0,0,0,0,0,0,1,1,0,Matches,2023
565,Sergi Roberto,es ESP,DF,Barcelona,30,1992,2.3,5,1,2,3,0,3,4,75.0,1,2,0,2,4,9,1,0,Matches,2023
566,Andrew Robertson,sct SCO,DF,Liverpool,28,1994,4.2,2,0,1,1,0,1,4,25.0,3,2,0,2,2,4,5,0,Matches,2023
567,Rochinha,pt POR,"MF,FW",Sporting CP,27,1995,0.2,0,0,0,0,0,0,0,,0,0,0,0,0,0,0,0,Matches,2023
568,Sebastian Rode,de GER,MF,Eint Frankfurt,31,1990,3.3,11,5,4,7,0,2,7,28.6,5,2,0,2,3,14,2,0,Matches,2023
569,Rodri,es ESP,MF,Manchester City,26,1996,11.1,24,15,13,9,2,12,17,70.6,5,11,3,8,13,37,9,1,Matches,2023
570,Rodrygo,br BRA,FW,Real Madrid,21,2001,9.1,7,3,3,3,1,3,8,37.5,5,13,4,9,9,16,6,0,Matches,2023
571,Cristian Romero,ar ARG,DF,Tottenham,24,1998,6.6,14,9,3,10,1,9,17,52.9,8,7,3,4,10,24,12,0,Matches,2023
572,Valentin Rongier,fr FRA,MF,Marseille,27,1994,5.2,15,6,7,7,1,5,6,83.3,1,3,0,3,8,23,5,0,Matches,2023
573,Tom Rothe,de GER,DF,Dortmund,17,2004,0.7,0,0,0,0,0,0,0,,0,4,1,3,1,1,4,0,Matches,2023
574,Amir Rrahmani,xk KVX,DF,Napoli,28,1994,6.8,9,6,6,2,1,5,9,55.6,4,9,4,5,2,11,27,1,Matches,2023
575,Antonio Rüdiger,de GER,DF,Real Madrid,29,1993,7.5,10,6,5,5,0,6,6,100.0,0,7,2,5,6,16,26,0,Matches,2023
576,Daniele Rugani,it ITA,DF,Juventus,28,1994,1.0,2,2,0,2,0,1,1,100.0,0,2,1,1,3,5,4,0,Matches,2023
577,Mário Rui,pt POR,DF,Napoli,31,1991,4.3,6,6,5,0,1,3,9,33.3,6,4,2,2,7,13,4,0,Matches,2023
578,Fabián Ruiz Peña,es ESP,MF,Paris S-G,26,1996,2.6,5,1,2,1,2,3,9,33.3,6,3,0,3,1,6,4,0,Matches,2023
579,Nikita Rukavytsya,au AUS,"FW,MF",Maccabi Haifa,35,1987,0.5,0,0,0,0,0,0,1,0.0,1,1,0,1,0,0,0,0,Matches,2023
580,Mathew Ryan,au AUS,GK,FC Copenhagen,30,1992,2.0,0,0,0,0,0,0,0,,0,0,0,0,0,0,0,0,Matches,2023
581,Julian Ryerson,no NOR,DF,Dortmund,24,1997,0.2,0,0,0,0,0,0,0,,0,1,0,1,0,0,4,1,Matches,2023
582,Marcel Sabitzer,at AUT,MF,Bayern Munich,28,1994,3.1,10,8,7,2,1,5,7,71.4,2,4,1,3,5,15,3,0,Matches,2023
583,Alexis Saelemaekers,be BEL,"FW,DF",Milan,23,1999,4.1,7,4,4,2,1,4,11,36.4,7,3,0,3,4,11,7,0,Matches,2023
584,Fashion Sakala,zm ZAM,"FW,MF",Rangers,25,1997,2.6,4,3,1,3,0,3,4,75.0,1,1,0,1,2,6,1,0,Matches,2023
585,Mohamed Salah,eg EGY,FW,Liverpool,30,1992,6.9,3,1,2,1,0,2,5,40.0,3,3,0,3,2,5,1,0,Matches,2023
586,Kike Salas,es ESP,DF,Sevilla,20,2002,2.0,5,3,4,1,0,4,4,100.0,0,4,1,3,1,6,3,0,Matches,2023
587,Renato Sanches,pt POR,MF,Paris S-G,24,1997,1.6,3,0,2,1,0,2,3,66.7,1,3,1,2,1,4,0,0,Matches,2023
588,Alexis Sánchez,cl CHI,FW,Marseille,33,1988,4.6,7,3,0,6,1,0,0,,0,3,0,3,0,7,0,0,Matches,2023
589,Davinson Sánchez,co COL,DF,Tottenham,26,1996,0.2,0,0,0,0,0,0,0,,0,1,1,0,0,0,1,0,Matches,2023
590,Cisse Sandra,be BEL,FW,Club Brugge,18,2003,0.1,0,0,0,0,0,0,0,,0,0,0,0,0,0,0,0,Matches,2023
591,Alex Sandro,br BRA,DF,Juventus,31,1991,2.7,3,2,2,1,0,0,0,,0,2,0,2,5,8,6,0,Matches,2023
592,James Sands,us USA,"DF,MF",Rangers,22,2000,3.6,5,3,1,4,0,1,1,100.0,0,2,1,1,4,9,9,0,Matches,2023
593,Leroy Sané,de GER,"FW,MF",Bayern Munich,26,1996,6.1,10,7,0,5,5,4,9,44.4,5,4,0,4,6,16,0,0,Matches,2023
594,Nuno Santos,pt POR,"DF,MF",Sporting CP,27,1995,3.3,7,5,7,0,0,6,7,85.7,1,4,1,3,2,9,8,0,Matches,2023
595,Zaidu Sanusi,ng NGA,DF,Porto,25,1997,6.5,13,9,8,4,1,6,9,66.7,3,6,1,5,11,24,20,0,Matches,2023
596,Alvaro Sanz,es ESP,MF,Barcelona,21,2001,0.2,0,0,0,0,0,0,0,,0,1,1,0,0,0,0,0,Matches,2023
597,Pablo Sarabia,es ESP,MF,Paris S-G,30,1992,1.0,1,1,1,0,0,1,1,100.0,0,1,0,1,0,1,0,0,Matches,2023
598,Stefan Savić,me MNE,DF,Atlético Madrid,31,1991,3.0,3,1,2,0,1,2,3,66.7,1,1,0,1,2,5,7,0,Matches,2023
599,Patrik Schick,cz CZE,FW,Leverkusen,26,1996,5.0,2,2,0,1,1,0,2,0.0,2,3,0,3,1,3,3,0,Matches,2023
600,Andreas Schjelderup,no NOR,FW,Benfica,18,2004,0.0,0,0,0,0,0,0,1,0.0,1,0,0,0,0,0,0,0,Matches,2023
601,Xaver Schlager,at AUT,MF,RB Leipzig,24,1997,6.5,11,7,4,7,0,7,12,58.3,5,12,3,9,5,16,2,1,Matches,2023
602,Nico Schlotterbeck,de GER,DF,Dortmund,22,1999,6.2,10,8,6,4,0,4,7,57.1,3,5,3,2,3,13,16,1,Matches,2023
603,Abdoulaye Seck,sn SEN,DF,Maccabi Haifa,30,1992,4.4,7,7,6,0,1,5,7,71.4,2,9,5,4,4,11,18,0,Matches,2023
604,Nicolas Seiwald,at AUT,MF,RB Salzburg,21,2001,6.0,19,14,13,5,1,9,15,60.0,6,14,3,11,8,27,5,0,Matches,2023
605,Benjamin Šeško,si SVN,FW,RB Salzburg,19,2003,3.7,3,1,0,1,2,1,1,100.0,0,4,1,3,0,3,2,0,Matches,2023
606,Ryan Sessegnon,eng ENG,"MF,DF",Tottenham,22,2000,1.7,9,7,4,3,2,2,4,50.0,2,1,0,1,2,11,8,1,Matches,2023
607,Maryan Shved,ua UKR,MF,Shakhtar,25,1997,2.1,6,2,4,2,0,3,7,42.9,4,4,0,4,4,10,2,0,Matches,2023
608,Danylo Sikan,ua UKR,FW,Shakhtar,21,2001,1.2,0,0,0,0,0,0,1,0.0,1,0,0,0,0,0,2,0,Matches,2023
609,André Silva,pt POR,FW,RB Leipzig,26,1995,5.9,6,3,2,1,3,3,4,75.0,1,7,0,7,1,7,1,0,Matches,2023
610,António Silva,pt POR,DF,Benfica,18,2003,9.9,11,7,9,2,0,7,11,63.6,4,13,4,9,14,25,34,0,Matches,2023
611,Bernardo Silva,pt POR,"FW,MF",Manchester City,27,1994,10.1,19,10,4,8,7,10,32,31.3,22,11,0,11,9,28,5,0,Matches,2023
612,Rafa Silva,pt POR,MF,Benfica,29,1993,9.1,11,5,2,5,4,7,14,50.0,7,7,1,6,1,12,0,0,Matches,2023
613,Thiago Silva,br BRA,DF,Chelsea,37,1984,7.1,8,6,6,1,1,3,4,75.0,1,8,6,2,9,17,32,0,Matches,2023
614,Mohamed Simakan,fr FRA,DF,RB Leipzig,22,2000,5.7,16,9,5,9,2,10,17,58.8,7,2,0,2,12,28,7,0,Matches,2023
615,Giovanni Simeone,ar ARG,FW,Napoli,27,1995,2.9,3,2,0,2,1,1,2,50.0,1,3,0,3,0,3,2,0,Matches,2023
616,Roko Simic,hr CRO,FW,RB Salzburg,18,2003,0.2,0,0,0,0,0,0,0,,0,0,0,0,0,0,0,0,Matches,2023
617,Oliver Skipp,eng ENG,MF,Tottenham,21,2000,2.3,8,4,2,6,0,4,9,44.4,5,4,0,4,2,10,4,0,Matches,2023
618,Leo Skiri Østigård,no NOR,DF,Napoli,22,1999,2.2,3,2,1,2,0,1,2,50.0,1,4,1,3,2,5,13,0,Matches,2023
619,Andreas Skov Olsen,dk DEN,"FW,MF",Club Brugge,22,1999,3.3,4,2,1,2,1,2,3,66.7,1,2,0,2,0,4,3,0,Matches,2023
620,Milan Škriniar,sk SVK,DF,Inter,27,1995,6.0,9,6,7,2,0,4,5,80.0,1,11,9,2,4,13,24,0,Matches,2023
621,Hrvoje Smolčić,hr CRO,DF,Eint Frankfurt,21,2000,1.4,1,1,1,0,0,0,0,,0,2,0,2,5,6,12,0,Matches,2023
622,Eduard Sobol,ua UKR,"FW,DF",Club Brugge,27,1995,1.2,3,1,3,0,0,2,3,66.7,1,1,0,1,2,5,3,0,Matches,2023
623,Carlos Soler,es ESP,MF,Paris S-G,25,1997,1.7,4,4,2,0,2,1,2,50.0,1,1,0,1,3,7,1,0,Matches,2023
624,Oumar Solet,fr FRA,DF,RB Salzburg,22,2000,3.0,5,4,3,1,1,2,2,100.0,0,7,3,4,3,8,13,0,Matches,2023
625,Yann Sommer,ch SUI,GK,Bayern Munich,33,1988,4.0,0,0,0,0,0,0,0,,0,0,0,0,0,0,6,1,Matches,2023
626,Matìas Soulé,ar ARG,"MF,FW",Juventus,19,2003,0.5,0,0,0,0,0,0,1,0.0,1,0,0,0,0,0,1,0,Matches,2023
627,Djibril Sow,ch SUI,MF,Eint Frankfurt,25,1997,8.0,14,8,4,8,2,7,12,58.3,5,10,1,9,18,32,3,0,Matches,2023
628,Kamal Sowah,gh GHA,"FW,MF",Club Brugge,22,2000,6.6,12,7,6,5,1,3,7,42.9,4,3,0,3,4,16,5,1,Matches,2023
629,Dario Špikić,hr CRO,"FW,DF",Dinamo Zagreb,23,1999,1.9,2,1,0,1,1,0,1,0.0,1,4,2,2,4,6,0,0,Matches,2023
630,Jorne Spileers,be BEL,DF,Club Brugge,17,2005,0.0,0,0,0,0,0,0,0,,0,0,0,0,0,0,4,0,Matches,2023
631,Jerry St. Juste,nl NED,DF,Sporting CP,25,1996,2.1,8,5,5,2,1,2,3,66.7,1,2,0,2,7,15,6,0,Matches,2023
632,Marko Stamenic,nz NZL,MF,FC Copenhagen,20,2002,3.0,3,1,1,1,1,1,6,16.7,5,8,2,6,3,6,2,0,Matches,2023
633,Jindřich Staněk,cz CZE,GK,Viktoria Plzeň,26,1996,5.0,0,0,0,0,0,0,0,,0,0,0,0,0,0,2,0,Matches,2023
634,Josip Stanišić,hr CRO,DF,Bayern Munich,22,2000,3.9,10,7,6,3,1,8,10,80.0,2,7,1,6,4,14,7,1,Matches,2023
635,Carl Starfelt,se SWE,DF,Celtic,27,1995,1.0,0,0,0,0,0,0,0,,0,3,3,0,0,0,5,0,Matches,2023
636,Orri Steinn Óskarsson,is ISL,"MF,FW",FC Copenhagen,17,2004,0.2,0,0,0,0,0,0,0,,0,0,0,0,0,0,0,0,Matches,2023
637,Taras Stepanenko,ua UKR,MF,Shakhtar,32,1989,5.9,18,11,12,5,1,10,28,35.7,18,2,1,1,12,30,21,1,Matches,2023
638,Raheem Sterling,eng ENG,"FW,MF",Chelsea,27,1994,7.0,8,2,3,4,1,3,9,33.3,6,3,0,3,0,8,2,0,Matches,2023
639,John Stones,eng ENG,"MF,DF",Manchester City,28,1994,7.6,2,2,2,0,0,1,3,33.3,2,6,4,2,4,6,10,0,Matches,2023
640,Luka Sučić,hr CRO,MF,RB Salzburg,19,2002,4.4,5,3,1,1,3,3,10,30.0,7,9,1,8,4,9,3,0,Matches,2023
641,Heorhii Sudakov,ua UKR,MF,Shakhtar,19,2002,5.3,9,6,7,1,1,4,7,57.1,3,1,0,1,6,15,5,1,Matches,2023
642,Niklas Süle,de GER,DF,Dortmund,26,1995,7.5,5,5,5,0,0,3,7,42.9,4,9,6,3,6,11,25,0,Matches,2023
643,Daniel Sundgren,se SWE,DF,Maccabi Haifa,31,1990,3.6,12,8,9,3,0,8,11,72.7,3,7,4,3,5,17,11,0,Matches,2023
644,Suso,es ESP,"FW,MF",Sevilla,28,1993,2.6,3,2,0,2,1,0,4,0.0,4,2,1,1,1,4,1,0,Matches,2023
645,Josip Šutalo,hr CRO,DF,Dinamo Zagreb,22,2000,6.0,12,6,11,1,0,6,8,75.0,2,12,6,6,9,21,27,0,Matches,2023
646,Jan Sýkora,cz CZE,"FW,DF",Viktoria Plzeň,28,1993,1.6,0,0,0,0,0,0,2,0.0,2,0,0,0,3,3,3,0,Matches,2023
647,Abakar Sylla,ci CIV,DF,Club Brugge,19,2002,5.5,6,2,5,1,0,3,3,100.0,0,7,5,2,7,13,17,1,Matches,2023
648,Wojciech Szczęsny,pl POL,GK,Juventus,32,1990,4.0,0,0,0,0,0,0,1,0.0,1,0,0,0,0,0,1,0,Matches,2023
649,Dominik Szoboszlai,hu HUN,FW,RB Leipzig,21,2000,7.3,8,6,3,4,1,4,16,25.0,12,8,0,8,1,9,4,0,Matches,2023
650,Christian Sørensen,dk DEN,"DF,MF",FC Copenhagen,29,1992,1.1,1,1,0,0,1,1,2,50.0,1,0,0,0,2,3,1,0,Matches,2023
651,Dušan Tadić,rs SRB,FW,Ajax,33,1988,4.8,6,3,1,3,2,4,8,50.0,4,8,1,7,0,6,5,0,Matches,2023
652,Jonathan Tah,de GER,DF,Leverkusen,26,1996,5.3,8,6,3,5,0,4,8,50.0,4,8,5,3,2,10,26,0,Matches,2023
653,Japhet Tanganga,eng ENG,DF,Tottenham,23,1999,0.2,1,1,1,0,0,1,1,100.0,0,0,0,0,0,1,0,0,Matches,2023
654,Edmond Tapsoba,bf BFA,DF,Leverkusen,23,1999,3.9,6,5,4,2,0,4,5,80.0,1,2,1,1,4,10,18,0,Matches,2023
655,Mehdi Taremi,ir IRN,FW,Porto,30,1992,6.8,8,6,0,3,5,4,11,36.4,7,6,0,6,1,9,10,0,Matches,2023
656,Ciprian Tătărușanu,ro ROU,GK,Milan,36,1986,5.0,0,0,0,0,0,0,0,,0,0,0,0,0,0,4,0,Matches,2023
657,Nuno Tavares,pt POR,DF,Marseille,22,2000,6.0,11,8,2,4,5,4,9,44.4,5,9,3,6,4,15,7,0,Matches,2023
658,James Tavernier,eng ENG,DF,Rangers,30,1991,5.4,11,5,6,5,0,8,11,72.7,3,7,4,3,6,17,13,1,Matches,2023
659,Greg Taylor,sct SCO,DF,Celtic,24,1997,6.0,14,9,4,7,3,9,12,75.0,3,8,4,4,7,21,6,0,Matches,2023
660,Kenneth Taylor,nl NED,MF,Ajax,20,2002,4.6,6,3,3,3,0,3,6,50.0,3,4,0,4,4,10,3,0,Matches,2023
661,Lucas Taylor,br BRA,DF,Shakhtar,27,1995,3.5,7,2,5,2,0,2,6,33.3,4,4,1,3,3,10,15,0,Matches,2023
662,Mavis Tchibota,cg CGO,FW,Maccabi Haifa,26,1996,1.0,2,2,0,1,1,1,5,20.0,4,0,0,0,0,2,0,0,Matches,2023
663,Aurélien Tchouaméni,fr FRA,MF,Real Madrid,22,2000,4.8,10,7,4,5,1,5,5,100.0,0,5,0,5,7,17,3,0,Matches,2023
664,Mathys Tel,fr FRA,FW,Bayern Munich,17,2005,1.6,1,1,1,0,0,1,1,100.0,0,5,0,5,3,4,0,0,Matches,2023
665,Alex Telles,br BRA,"DF,FW",Sevilla,29,1992,4.3,8,4,3,1,4,4,7,57.1,3,7,2,5,4,12,10,1,Matches,2023
666,Marc-André ter Stegen,de GER,GK,Barcelona,30,1992,5.0,0,0,0,0,0,0,0,,0,0,0,0,0,0,0,0,Matches,2023
667,Kévin Théophile-Catherine,fr FRA,DF,Dinamo Zagreb,32,1989,0.8,2,2,1,1,0,2,2,100.0,0,1,1,0,1,3,1,0,Matches,2023
668,Malick Thiaw,de GER,DF,Milan,20,2001,3.1,10,4,7,3,0,5,7,71.4,2,6,5,1,10,20,12,0,Matches,2023
669,Mohamed Tijani,bj BEN,DF,Viktoria Plzeň,25,1997,1.9,2,0,0,2,0,0,1,0.0,1,3,1,2,2,4,10,0,Matches,2023
670,Malik Tillman,us USA,MF,Rangers,20,2002,2.7,10,5,3,4,3,6,9,66.7,3,2,0,2,3,13,4,0,Matches,2023
671,Jurriën Timber,nl NED,DF,Ajax,21,2001,5.9,4,1,1,3,0,1,1,100.0,0,9,6,3,8,12,14,1,Matches,2023
672,Fikayo Tomori,eng ENG,DF,Milan,24,1997,9.2,22,16,13,9,0,11,14,78.6,3,12,8,4,10,32,29,0,Matches,2023
673,Sandro Tonali,it ITA,MF,Milan,22,2000,11.7,19,13,7,11,1,9,19,47.4,10,11,3,8,4,23,10,0,Matches,2023
674,Pablo Torre,es ESP,"MF,FW",Barcelona,19,2003,1.1,2,2,0,2,0,0,0,,0,1,1,0,1,3,0,1,Matches,2023
675,Ferrán Torres,es ESP,"FW,MF",Barcelona,22,2000,2.1,2,2,0,0,2,1,2,50.0,1,0,0,0,0,2,1,0,Matches,2023
676,Andriy Totovytskyi,ua UKR,MF,Shakhtar,29,1993,0.2,0,0,0,0,0,0,0,,0,0,0,0,0,0,1,0,Matches,2023
677,Kevin Trapp,de GER,GK,Eint Frankfurt,32,1990,8.0,0,0,0,0,0,0,0,,0,0,0,0,0,0,1,0,Matches,2023
678,Francisco Trincão,pt POR,"MF,FW",Sporting CP,22,1999,4.3,5,4,1,4,0,2,4,50.0,2,3,0,3,2,7,3,0,Matches,2023
679,Anatolii Trubin,ua UKR,GK,Shakhtar,20,2001,6.0,0,0,0,0,0,0,1,0.0,1,0,0,0,0,0,1,1,Matches,2023
680,Kostas Tsimikas,gr GRE,DF,Liverpool,26,1996,3.8,5,3,1,4,0,2,3,66.7,1,5,3,2,2,7,6,0,Matches,2023
681,David Turnbull,sct SCO,MF,Celtic,23,1999,1.1,1,0,1,0,0,0,2,0.0,2,2,1,1,0,1,0,0,Matches,2023
682,Tuta,br BRA,DF,Eint Frankfurt,23,1999,6.7,19,11,12,6,1,9,21,42.9,12,6,0,6,8,27,26,1,Matches,2023
683,Marián Tvrdoň,sk SVK,GK,Viktoria Plzeň,27,1994,1.0,0,0,0,0,0,0,0,,0,0,0,0,0,0,0,0,Matches,2023
684,Manuel Ugarte Ribeiro,uy URU,MF,Sporting CP,21,2001,5.2,29,17,10,18,1,7,14,50.0,7,8,0,8,13,42,8,1,Matches,2023
685,Andreas Ulmer,at AUT,DF,RB Salzburg,36,1985,4.2,7,1,2,3,2,3,9,33.3,6,3,0,3,4,11,13,0,Matches,2023
686,Sven Ulreich,de GER,GK,Bayern Munich,33,1988,3.0,0,0,0,0,0,0,0,,0,0,0,0,0,0,0,0,Matches,2023
687,Cengiz Ünder,tr TUR,MF,Marseille,25,1997,1.9,3,3,1,1,1,1,2,50.0,1,0,0,0,1,4,0,0,Matches,2023
688,Dayot Upamecano,fr FRA,DF,Bayern Munich,23,1998,7.9,14,8,10,4,0,8,11,72.7,3,7,3,4,14,28,22,2,Matches,2023
689,Mateus Uribe,co COL,MF,Porto,31,1991,6.8,10,9,3,6,1,3,14,21.4,11,6,3,3,11,21,11,0,Matches,2023
690,Jesús Vallejo,es ESP,DF,Real Madrid,25,1997,0.2,2,2,1,0,1,2,2,100.0,0,1,1,0,0,2,2,0,Matches,2023
691,Federico Valverde,uy URU,"MF,FW",Real Madrid,24,1998,10.7,18,7,6,7,5,9,20,45.0,11,17,1,16,14,32,13,0,Matches,2023
692,Virgil van Dijk,nl NED,DF,Liverpool,31,1991,8.0,4,2,3,1,0,1,4,25.0,3,4,4,0,4,8,22,0,Matches,2023
693,Hans Vanaken,be BEL,MF,Club Brugge,29,1992,7.8,5,3,2,2,1,2,5,40.0,3,10,2,8,4,9,11,0,Matches,2023
694,Denis Vavro,sk SVK,DF,FC Copenhagen,26,1996,4.0,3,1,3,0,0,2,3,66.7,1,7,6,1,7,10,22,0,Matches,2023
695,Lucas Vázquez,es ESP,DF,Real Madrid,31,1991,2.2,4,1,1,3,0,0,4,0.0,4,1,0,1,3,7,4,0,Matches,2023
696,Jordan Veretout,fr FRA,MF,Marseille,29,1993,5.4,16,9,5,10,1,6,9,66.7,3,4,1,3,2,18,5,0,Matches,2023
697,Lucas Veríssimo,br BRA,DF,Benfica,27,1995,0.1,0,0,0,0,0,0,1,0.0,1,1,1,0,0,0,1,0,Matches,2023
698,Gabriel Veron,br BRA,"MF,FW",Porto,19,2002,0.5,1,0,1,0,0,1,1,100.0,0,2,0,2,0,1,0,0,Matches,2023
699,Marco Verratti,it ITA,MF,Paris S-G,29,1992,6.9,27,18,12,12,3,9,28,32.1,19,13,5,8,6,33,0,2,Matches,2023
700,Vitinha,pt POR,MF,Paris S-G,22,2000,6.5,8,6,3,4,1,1,11,9.1,10,8,1,7,13,21,1,0,Matches,2023
701,Odisseas Vlachodimos,gr GRE,GK,Benfica,28,1994,10.0,0,0,0,0,0,0,1,0.0,1,1,0,1,0,0,5,0,Matches,2023
702,Dušan Vlahović,rs SRB,FW,Juventus,22,2000,4.6,1,1,0,1,0,0,2,0.0,2,2,1,1,0,1,4,0,Matches,2023
703,Adam Vlkanova,cz CZE,MF,Viktoria Plzeň,27,1994,5.1,5,2,2,2,1,2,5,40.0,3,3,2,1,2,7,5,0,Matches,2023
704,Stefan de Vrij,nl NED,DF,Inter,30,1992,3.3,10,4,9,1,0,4,5,80.0,1,6,4,2,4,14,21,0,Matches,2023
705,Kyle Walker,eng ENG,"DF,FW",Manchester City,32,1990,3.1,9,7,4,3,2,7,9,77.8,2,1,1,0,3,12,8,0,Matches,2023
706,Paul Wanner,de GER,"DF,FW",Bayern Munich,16,2005,0.4,0,0,0,0,0,0,0,,0,0,0,0,1,1,0,0,Matches,2023
707,Stephen Welsh,sct SCO,DF,Celtic,22,2000,1.0,0,0,0,0,0,0,0,,0,1,1,0,1,1,6,0,Matches,2023
708,Wendell,br BRA,DF,Porto,29,1993,1.6,3,1,2,1,0,1,3,33.3,2,2,0,2,1,4,3,0,Matches,2023
709,Timo Werner,de GER,FW,RB Leipzig,26,1996,5.6,2,0,1,1,0,0,5,0.0,5,3,0,3,0,2,3,1,Matches,2023
710,Owen Wijndal,nl NED,DF,Ajax,22,1999,0.8,1,0,0,1,0,1,1,100.0,0,1,0,1,2,3,4,0,Matches,2023
711,Josh Wilson-Esbrand,eng ENG,DF,Manchester City,19,2002,0.5,1,1,1,0,0,1,1,100.0,0,0,0,0,0,1,0,0,Matches,2023
712,Axel Witsel,be BEL,"DF,MF",Atlético Madrid,33,1989,5.1,6,3,4,2,0,3,6,50.0,3,10,9,1,3,9,8,0,Matches,2023
713,Maximilian Wöber,at AUT,DF,RB Salzburg,24,1998,1.8,9,6,6,2,1,3,5,60.0,2,3,1,2,0,9,5,0,Matches,2023
714,Marius Wolf,de GER,DF,Dortmund,27,1995,2.0,3,3,1,1,1,2,4,50.0,2,3,0,3,2,5,6,0,Matches,2023
715,Scott Wright,sct SCO,"FW,MF",Rangers,24,1997,1.5,3,1,1,1,1,1,2,50.0,1,0,0,0,1,4,2,0,Matches,2023
716,Roman Yaremchuk,ua UKR,FW,Club Brugge,26,1995,1.2,1,1,0,0,1,0,1,0.0,1,1,0,1,0,1,0,0,Matches,2023
717,Rıdvan Yılmaz,tr TUR,DF,Rangers,21,2001,1.0,1,0,1,0,0,0,2,0.0,2,0,0,0,3,4,2,0,Matches,2023
718,Warren Zaire-Emery,fr FRA,MF,Paris S-G,16,2006,0.9,2,2,1,1,0,2,5,40.0,3,0,0,0,0,2,0,0,Matches,2023
719,Denis Zakaria,ch SUI,MF,Chelsea,25,1996,0.8,1,1,1,0,0,1,2,50.0,1,0,0,0,2,3,1,0,Matches,2023
720,Andre-Frank Zambo Anguissa,cm CMR,MF,Napoli,26,1995,7.2,14,8,4,5,5,4,8,50.0,4,5,1,4,14,28,5,0,Matches,2023
721,Alessandro Zanoli,it ITA,DF,Napoli,21,2000,0.1,2,2,2,0,0,1,1,100.0,0,0,0,0,1,3,0,0,Matches,2023
722,Zeca,gr GRE,MF,FC Copenhagen,33,1988,1.8,4,0,2,2,0,2,6,33.3,4,7,1,6,3,7,2,0,Matches,2023
723,Alessio Zerbin,it ITA,FW,Napoli,23,1999,0.6,2,1,0,1,1,0,1,0.0,1,4,1,3,0,2,0,0,Matches,2023
724,Piotr Zieliński,pl POL,MF,Napoli,28,1994,6.9,8,4,0,6,2,0,2,0.0,2,3,0,3,4,12,4,1,Matches,2023
725,Hakim Ziyech,ma MAR,"FW,MF",Chelsea,29,1993,1.6,0,0,0,0,0,0,4,0.0,4,6,1,5,2,2,0,0,Matches,2023
726,Oleksandr Zubkov,ua UKR,"FW,MF",Shakhtar,25,1996,4.1,7,4,4,2,1,0,2,0.0,2,4,0,4,4,11,3,0,Matches,2023
727,Neven Đurasek,hr CRO,MF,Shakhtar,23,1998,1.0,1,0,0,0,1,0,0,,0,1,1,0,4,5,2,0,Matches,2023
1,Brenden Aaronson,us USA,MF,RB Salzburg,20,2000,7.9,14,6,2,6,6,8,22,36.4,14,6,1,5,2,16,4,0,Matches,2022
2,Malik Abubakari,gh GHA,FW,Malmö,21,2000,1.3,0,0,0,0,0,0,0,,0,2,0,2,0,0,3,0,Matches,2022
3,Marcos Acuña,ar ARG,DF,Sevilla,29,1991,4.2,15,10,8,5,2,6,13,46.2,7,4,1,3,7,22,4,1,Matches,2022
4,Tyler Adams,us USA,MF,RB Leipzig,22,1999,3.3,9,4,5,2,2,3,8,37.5,5,5,3,2,2,11,4,1,Matches,2022
5,Junior Adamu,at AUT,FW,RB Salzburg,20,2001,2.6,4,2,1,2,1,1,1,100.0,0,2,0,2,0,4,0,0,Matches,2022
6,Antonio Adán,es ESP,GK,Sporting CP,34,1987,7.0,0,0,0,0,0,0,2,0.0,2,0,0,0,0,0,2,0,Matches,2022
7,Edmund Addo,gh GHA,MF,Sheriff Tiraspol,21,2000,5.4,19,9,12,5,2,6,16,37.5,10,13,4,9,11,30,5,0,Matches,2022
8,Karim Adeyemi,de GER,FW,RB Salzburg,19,2002,6.7,3,0,2,1,0,1,4,25.0,3,3,0,3,2,5,0,0,Matches,2022
9,Michel Aebischer,ch SUI,MF,Young Boys,24,1997,5.6,8,4,4,2,2,4,12,33.3,8,3,1,2,10,18,2,0,Matches,2022
10,Sergio Agüero,ar ARG,FW,Barcelona,33,1988,0.2,0,0,0,0,0,0,0,,0,0,0,0,0,0,0,0,Matches,2022
11,Anel Ahmedhodžić,ba BIH,DF,Malmö,22,1999,4.6,2,2,2,0,0,0,0,,0,7,4,3,13,15,19,0,Matches,2022
12,Manuel Akanji,ch SUI,DF,Dortmund,26,1995,5.0,6,6,5,1,0,3,6,50.0,3,9,2,7,9,15,13,0,Matches,2022
13,Nathan Aké,nl NED,DF,Manchester City,26,1995,3.6,4,2,3,1,0,2,3,66.7,1,1,0,1,12,16,17,0,Matches,2022
14,David Alaba,at AUT,DF,Real Madrid,29,1992,11.5,16,9,11,4,1,5,7,71.4,2,8,8,0,11,27,28,1,Matches,2022
15,Jordi Alba,es ESP,"DF,FW",Barcelona,32,1989,4.1,2,2,0,2,0,2,7,28.6,5,3,0,3,6,8,5,0,Matches,2022
16,Raúl Albiol,es ESP,DF,Villarreal,35,1985,11.6,10,4,6,4,0,4,9,44.4,5,23,16,7,7,17,60,0,Matches,2022
17,Paco Alcácer,es ESP,FW,Villarreal,27,1993,0.8,1,1,0,1,0,0,0,,0,0,0,0,0,1,0,0,Matches,2022
18,Thiago Alcántara,es ESP,MF,Liverpool,30,1991,6.7,13,11,3,7,3,6,16,37.5,10,10,0,10,16,29,9,1,Matches,2022
19,Trent Alexander-Arnold,eng ENG,DF,Liverpool,22,1998,8.8,17,7,8,5,4,12,27,44.4,15,6,0,6,9,26,11,0,Matches,2022
20,Alisson,br BRA,GK,Liverpool,28,1992,13.0,1,1,1,0,0,1,2,50.0,1,1,0,1,0,1,5,0,Matches,2022
21,André Almeida,pt POR,"DF,MF",Benfica,30,1990,2.6,9,5,6,3,0,5,8,62.5,3,0,0,0,3,12,6,0,Matches,2022
22,Marcos Alonso,es ESP,"DF,MF",Chelsea,30,1990,6.1,10,6,6,2,2,6,13,46.2,7,8,0,8,8,18,5,0,Matches,2022
23,Éder Álvarez Balanta,co COL,MF,Club Brugge,28,1993,4.5,14,8,10,3,1,5,14,35.7,9,12,3,9,12,26,5,0,Matches,2022
24,Edson Álvarez,mx MEX,MF,Ajax,23,1997,6.2,17,13,6,9,2,10,21,47.6,11,8,1,7,4,21,11,0,Matches,2022
25,Mohamed Aly Camara,gn GUI,DF,Young Boys,23,1997,3.8,9,4,9,0,0,6,10,60.0,4,6,3,3,7,16,8,0,Matches,2022
26,Benjamin André,fr FRA,MF,Lille,30,1990,7.0,18,8,8,6,4,11,26,42.3,15,13,1,12,8,26,8,1,Matches,2022
27,Oleksandr Andriyevskyi,ua UKR,MF,Dynamo Kyiv,27,1994,1.1,3,1,3,0,0,0,4,0.0,4,1,0,1,2,5,0,0,Matches,2022
28,Angeliño,es ESP,DF,RB Leipzig,24,1997,4.8,1,1,0,1,0,1,4,25.0,3,3,0,3,5,6,9,0,Matches,2022
29,Marcos Antônio,br BRA,MF,Shakhtar,21,2000,2.8,5,4,4,1,0,2,4,50.0,2,2,1,1,3,8,0,0,Matches,2022
30,Antony,br BRA,FW,Ajax,21,2000,6.4,11,7,3,6,2,5,12,41.7,7,11,0,11,3,14,0,0,Matches,2022
31,Ronald Araújo,uy URU,DF,Barcelona,22,1999,4.1,9,8,4,5,0,3,5,60.0,2,6,1,5,4,13,13,0,Matches,2022
32,Danilo Arboleda,co COL,DF,Sheriff Tiraspol,26,1995,6.0,3,2,1,2,0,3,5,60.0,2,11,5,6,12,15,34,0,Matches,2022
33,Maximilian Arnold,de GER,MF,Wolfsburg,27,1994,6.0,11,6,4,5,2,5,14,35.7,9,6,2,4,5,16,7,0,Matches,2022
34,Kepa Arrizabalaga,es ESP,GK,Chelsea,26,1994,1.0,0,0,0,0,0,0,1,0.0,1,0,0,0,0,0,0,0,Matches,2022
35,Marco Asensio,es ESP,"FW,MF",Real Madrid,25,1996,2.3,4,2,0,3,1,1,5,20.0,4,0,0,0,0,4,1,0,Matches,2022
36,Giorgos Athanasiadis,gr GRE,GK,Sheriff Tiraspol,28,1993,5.0,0,0,0,0,0,0,0,,0,0,0,0,2,2,2,0,Matches,2022
37,Ludwig Augustinsson,se SWE,DF,Sevilla,27,1994,0.9,1,0,0,1,0,1,1,100.0,0,0,0,0,3,4,2,0,Matches,2022
38,Serge Aurier,ci CIV,DF,Villarreal,28,1992,1.5,3,2,3,0,0,1,4,25.0,3,2,1,1,4,7,5,0,Matches,2022
39,Sardar Azmoun,ir IRN,FW,Zenit,26,1995,3.4,4,1,1,3,0,0,1,0.0,1,1,0,1,2,6,4,0,Matches,2022
40,César Azpilicueta,es ESP,DF,Chelsea,31,1989,7.5,12,8,3,3,6,7,14,50.0,7,16,2,14,9,21,10,0,Matches,2022
41,Eric Bailly,ci CIV,DF,Manchester Utd,27,1994,2.0,3,2,3,0,0,1,2,50.0,1,6,4,2,5,8,7,0,Matches,2022
42,Tiemoué Bakayoko,fr FRA,"MF,FW",Milan,26,1994,0.7,3,3,1,2,0,1,3,33.3,2,2,0,2,2,5,0,0,Matches,2022
43,Ridle Baku,de GER,"FW,DF",Wolfsburg,23,1998,4.6,10,6,5,4,1,6,10,60.0,4,5,2,3,2,12,9,0,Matches,2022
44,Alejandro Balde,es ESP,"DF,FW",Barcelona,17,2003,0.2,0,0,0,0,0,0,1,0.0,1,0,0,0,0,0,0,0,Matches,2022
45,Gareth Bale,wls WAL,FW,Real Madrid,32,1989,0.1,0,0,0,0,0,0,0,,0,0,0,0,0,0,0,0,Matches,2022
46,David von Ballmoos,ch SUI,GK,Young Boys,26,1994,3.0,0,0,0,0,0,0,0,,0,0,0,0,1,1,0,0,Matches,2022
47,Fodé Ballo-Touré,sn SEN,"DF,MF",Milan,24,1997,1.0,8,3,4,4,0,3,6,50.0,3,0,0,0,3,11,2,0,Matches,2022
48,Jonathan Bamba,ci CIV,"MF,FW",Lille,25,1996,5.2,8,7,3,4,1,6,12,50.0,6,5,0,5,7,15,6,0,Matches,2022
49,Nicolò Barella,it ITA,MF,Inter,24,1997,5.5,15,6,2,6,7,7,16,43.8,9,3,0,3,5,20,0,0,Matches,2022
50,Ross Barkley,eng ENG,MF,Chelsea,27,1993,1.1,0,0,0,0,0,0,0,,0,1,0,1,0,0,0,0,Matches,2022
51,Wílmar Barrios,co COL,"MF,DF",Zenit,27,1993,6.0,15,10,11,4,0,10,17,58.8,7,8,0,8,9,24,11,0,Matches,2022
52,Gil Bastião Dias,pt POR,FW,Benfica,24,1996,0.0,0,0,0,0,0,0,0,,0,0,0,0,0,0,0,0,Matches,2022
53,Alessandro Bastoni,it ITA,DF,Inter,22,1999,7.4,7,5,5,2,0,3,9,33.3,6,13,1,12,6,13,16,0,Matches,2022
54,Michy Batshuayi,be BEL,FW,Beşiktaş,27,1993,4.3,3,3,1,1,1,1,3,33.3,2,1,0,1,1,4,2,0,Matches,2022
55,Donny van de Beek,nl NED,MF,Manchester Utd,24,1997,2.3,8,3,6,2,0,2,4,50.0,2,4,2,2,5,13,2,1,Matches,2022
56,Jude Bellingham,eng ENG,"MF,FW",Dortmund,18,2003,5.6,12,8,4,8,0,6,12,50.0,6,10,1,9,7,19,7,0,Matches,2022
57,Hatem Ben Arfa,fr FRA,"FW,MF",Lille,34,1987,0.3,0,0,0,0,0,0,0,,0,0,0,0,0,0,0,0,Matches,2022
58,Ismaël Bennacer,dz ALG,MF,Milan,23,1997,4.2,15,8,5,9,1,10,16,62.5,6,6,1,5,5,20,4,1,Matches,2022
59,Rodrigo Bentancur,uy URU,"MF,FW",Juventus,24,1997,4.2,14,8,7,4,3,4,6,66.7,2,6,1,5,4,18,1,0,Matches,2022
60,Karim Benzema,fr FRA,FW,Real Madrid,33,1987,12.2,3,2,0,2,1,0,7,0.0,7,11,0,11,1,4,11,0,Matches,2022
61,Steven Berghuis,nl NED,MF,Ajax,29,1991,6.9,5,2,1,3,1,0,5,0.0,5,4,0,4,2,7,3,0,Matches,2022
62,Federico Bernardeschi,it ITA,"FW,MF",Juventus,27,1994,3.2,2,1,0,0,2,0,3,0.0,3,4,1,3,5,7,1,0,Matches,2022
63,Bernardo,br BRA,"DF,MF",RB Salzburg,26,1995,0.3,0,0,0,0,0,0,0,,0,1,1,0,0,0,0,0,Matches,2022
64,Paulo Bernardo,pt POR,MF,Benfica,19,2002,0.5,1,1,1,0,0,0,0,,0,0,0,0,0,1,1,0,Matches,2022
65,Veljko Birmančević,rs SRB,"MF,FW",Malmö,23,1998,3.9,7,4,3,2,2,5,8,62.5,3,4,1,3,2,9,2,0,Matches,2022
66,Daley Blind,nl NED,DF,Ajax,31,1990,6.3,12,5,6,6,0,6,12,50.0,6,12,3,9,5,17,11,0,Matches,2022
67,Valerii Bondar,ua UKR,DF,Shakhtar,22,1999,1.0,0,0,0,0,0,0,0,,0,1,1,0,1,1,2,0,Matches,2022
68,Artem Bondarenko,ua UKR,MF,Shakhtar,20,2000,0.9,2,2,0,1,1,1,3,33.3,2,2,0,2,1,3,0,0,Matches,2022
69,Solomon Bonnah,nl NED,DF,RB Leipzig,17,2003,0.1,0,0,0,0,0,0,0,,0,0,0,0,0,0,2,0,Matches,2022
70,Leonardo Bonucci,it ITA,DF,Juventus,34,1987,6.4,8,5,5,3,0,2,4,50.0,2,9,9,0,15,23,17,0,Matches,2022
71,Sebastiaan Bornauw,be BEL,DF,Wolfsburg,22,1999,2.3,3,3,3,0,0,2,4,50.0,2,4,3,1,2,5,12,0,Matches,2022
72,Sven Botman,nl NED,DF,Lille,21,2000,4.6,6,3,5,1,0,3,4,75.0,1,3,2,1,3,9,20,0,Matches,2022
73,Yassine Bounou,ma MAR,GK,Sevilla,30,1991,6.0,0,0,0,0,0,0,0,,0,0,0,0,0,0,1,0,Matches,2022
74,Denys Boyko,ua UKR,GK,Dynamo Kyiv,33,1988,1.0,0,0,0,0,0,0,0,,0,0,0,0,0,0,1,0,Matches,2022
75,Can Bozdogan,de GER,MF,Beşiktaş,20,2001,2.4,4,4,2,2,0,0,5,0.0,5,0,0,0,1,5,0,0,Matches,2022
76,Domagoj Bradarić,hr CRO,DF,Lille,21,1999,0.2,1,1,0,0,1,1,1,100.0,0,0,0,0,0,1,0,0,Matches,2022
77,Conor Bradley,nir NIR,FW,Liverpool,18,2003,0.0,0,0,0,0,0,0,0,,0,0,0,0,0,0,0,0,Matches,2022
78,Daniel Bragança,pt POR,MF,Sporting CP,22,1999,1.5,9,5,2,6,1,3,8,37.5,5,2,0,2,4,13,0,0,Matches,2022
79,Julian Brandt,de GER,"MF,FW",Dortmund,25,1996,4.4,6,4,3,2,1,5,16,31.3,11,8,0,8,4,10,2,0,Matches,2022
80,Brian Brobbey,nl NED,FW,Ajax,19,2002,0.1,0,0,0,0,0,0,0,,0,0,0,0,0,0,0,0,Matches,2022
81,Brian Brobbey,nl NED,"FW,MF",RB Leipzig,19,2002,1.2,1,1,0,1,0,0,0,,0,1,0,1,0,1,0,0,Matches,2022
82,John Brooks,us USA,DF,Wolfsburg,28,1993,3.7,4,3,2,2,0,2,5,40.0,3,0,0,0,7,11,19,1,Matches,2022
83,Franz Brorsson,se SWE,DF,Malmö,25,1996,5.0,5,3,4,1,0,2,10,20.0,8,5,5,0,9,14,19,0,Matches,2022
84,Marcelo Brozović,hr CRO,MF,Inter,28,1992,7.0,19,10,8,7,4,5,18,27.8,13,4,1,3,14,33,9,0,Matches,2022
85,Nicolas Bürgy,ch SUI,DF,Young Boys,25,1995,2.0,3,0,2,1,0,1,1,100.0,0,0,0,0,3,6,5,0,Matches,2022
86,Heorhiy Bushchan,ua UKR,GK,Dynamo Kyiv,27,1994,5.0,0,0,0,0,0,0,0,,0,0,0,0,0,0,4,1,Matches,2022
87,Sergio Busquets,es ESP,MF,Barcelona,33,1988,5.4,15,8,6,3,6,11,22,50.0,11,5,2,3,11,26,5,0,Matches,2022
88,Vitaliy Buyalskyi,ua UKR,"FW,MF",Dynamo Kyiv,28,1993,4.8,3,3,0,3,0,0,7,0.0,7,1,0,1,2,5,0,0,Matches,2022
89,Jovane Cabral,cv CPV,"FW,MF",Sporting CP,23,1998,0.9,2,0,2,0,0,1,4,25.0,3,0,0,0,2,4,0,0,Matches,2022
90,Davide Calabria,it ITA,DF,Milan,24,1996,3.5,14,7,10,4,0,8,15,53.3,7,7,1,6,2,16,13,0,Matches,2022
91,Hakan Çalhanoğlu,tr TUR,MF,Inter,27,1994,4.6,5,2,1,4,0,3,7,42.9,4,4,0,4,2,7,2,0,Matches,2022
92,Mohamed Camara,ml MLI,MF,RB Salzburg,21,2000,7.4,17,10,7,8,2,9,23,39.1,14,9,2,7,12,29,5,0,Matches,2022
93,Eduardo Camavinga,fr FRA,MF,Real Madrid,18,2002,3.4,14,7,3,8,3,5,14,35.7,9,7,1,6,0,14,6,0,Matches,2022
94,Emre Can,de GER,DF,Dortmund,27,1994,0.8,1,1,1,0,0,0,2,0.0,2,1,0,1,0,1,0,0,Matches,2022
95,João Cancelo,pt POR,DF,Manchester City,27,1994,9.3,13,9,9,2,2,7,17,41.2,10,6,1,5,25,38,8,0,Matches,2022
96,Nicolás Capaldo,ar ARG,MF,RB Salzburg,23,1997,3.2,13,7,9,2,2,5,16,31.3,11,9,2,7,11,24,6,0,Matches,2022
97,Étienne Capoue,fr FRA,MF,Villarreal,33,1988,11.6,14,10,8,6,0,7,14,50.0,7,17,5,12,24,38,25,2,Matches,2022
98,Fábio Cardoso,pt POR,DF,Porto,27,1994,1.7,0,0,0,0,0,0,1,0.0,1,4,2,2,3,3,7,0,Matches,2022
99,Diego Carlos,br BRA,DF,Sevilla,28,1993,6.0,7,3,4,3,0,6,9,66.7,3,10,6,4,3,10,21,2,Matches,2022
100,Yannick Carrasco,be BEL,"FW,MF",Atlético Madrid,27,1993,5.2,7,5,5,2,0,3,15,20.0,12,1,0,1,2,9,2,0,Matches,2022
101,Scott Carson,eng ENG,GK,Manchester City,35,1985,0.2,0,0,0,0,0,0,0,,0,0,0,0,0,0,0,0,Matches,2022
102,Dani Carvajal,es ESP,DF,Real Madrid,29,1992,10.6,16,12,11,5,0,9,24,37.5,15,18,10,8,12,28,29,0,Matches,2022
103,Casemiro,br BRA,MF,Real Madrid,29,1992,10.1,30,20,16,12,2,11,30,36.7,19,17,5,12,16,46,20,0,Matches,2022
104,Frank Castañeda,co COL,"FW,MF",Sheriff Tiraspol,27,1994,3.9,3,0,3,0,0,2,10,20.0,8,6,0,6,1,4,3,0,Matches,2022
105,Koen Casteels,be BEL,GK,Wolfsburg,29,1992,5.0,0,0,0,0,0,0,0,,0,0,0,0,0,0,1,0,Matches,2022
106,Edinson Cavani,uy URU,FW,Manchester Utd,34,1987,0.9,1,1,1,0,0,1,1,100.0,0,0,0,0,0,1,2,0,Matches,2022
107,Dani Ceballos,es ESP,"MF,FW",Real Madrid,24,1996,0.5,5,1,3,2,0,2,6,33.3,4,0,0,0,1,6,1,0,Matches,2022
108,Dumitru Celeadnic,md MDA,GK,Sheriff Tiraspol,29,1992,1.0,0,0,0,0,0,0,0,,0,0,0,0,0,0,1,0,Matches,2022
109,Zeki Çelik,tr TUR,DF,Lille,24,1997,6.5,22,14,9,11,2,13,20,65.0,7,8,1,7,3,25,11,0,Matches,2022
110,Trevoh Chalobah,eng ENG,DF,Chelsea,22,1999,2.0,0,0,0,0,0,0,2,0.0,2,1,0,1,3,3,6,0,Matches,2022
111,Giorgio Chiellini,it ITA,DF,Juventus,36,1984,0.1,0,0,0,0,0,0,0,,0,0,0,0,0,0,3,0,Matches,2022
112,Federico Chiesa,it ITA,"FW,MF",Juventus,23,1997,3.7,3,2,0,1,2,1,6,16.7,5,2,1,1,1,4,0,0,Matches,2022
113,Ben Chilwell,eng ENG,DF,Chelsea,24,1996,2.1,7,5,0,4,3,3,3,100.0,0,2,0,2,1,8,1,0,Matches,2022
114,Dmitri Chistyakov,ru RUS,DF,Zenit,27,1994,4.9,2,0,1,0,1,0,3,0.0,3,6,6,0,4,6,17,0,Matches,2022
115,Andreas Christensen,dk DEN,DF,Chelsea,25,1996,6.7,8,3,1,6,1,3,5,60.0,2,5,2,3,7,15,10,0,Matches,2022
116,Anders Christiansen,dk DEN,MF,Malmö,31,1990,3.6,2,0,1,1,0,2,5,40.0,3,2,0,2,4,6,2,0,Matches,2022
117,Samuel Chukwueze,ng NGA,"MF,FW",Villarreal,22,1999,3.1,4,1,1,1,2,2,6,33.3,4,1,0,1,1,5,2,0,Matches,2022
118,Claudinho,br BRA,"MF,FW",Zenit,24,1997,5.1,10,5,5,2,3,2,13,15.4,11,8,1,7,5,15,6,0,Matches,2022
119,Sebastián Coates,uy URU,DF,Sporting CP,30,1990,6.0,11,6,7,4,0,7,12,58.3,5,9,6,3,9,20,25,0,Matches,2022
120,Serafim Cojocari,md MDA,FW,Sheriff Tiraspol,20,2001,0.0,0,0,0,0,0,0,0,,0,0,0,0,0,0,0,0,Matches,2022
121,Maxim Cojocaru,md MDA,"FW,MF",Sheriff Tiraspol,23,1998,0.2,0,0,0,0,0,0,0,,0,0,0,0,0,0,1,0,Matches,2022
122,Antonio Čolak,hr CRO,FW,Malmö,27,1993,5.5,1,1,0,1,0,0,6,0.0,6,4,0,4,1,2,2,0,Matches,2022
123,Kingsley Coman,fr FRA,FW,Bayern Munich,25,1996,7.0,11,6,5,4,2,7,10,70.0,3,11,1,10,2,13,2,0,Matches,2022
124,Francisco Conceição,pt POR,MF,Porto,18,2002,0.4,0,0,0,0,0,0,2,0.0,2,2,0,2,1,1,0,0,Matches,2022
125,Francis Coquelin,fr FRA,MF,Villarreal,30,1991,5.1,6,4,2,4,0,3,10,30.0,7,9,4,5,10,16,7,0,Matches,2022
126,Jesús Corona,mx MEX,"DF,FW",Porto,28,1993,2.4,6,2,5,1,0,1,3,33.3,2,3,0,3,3,9,6,0,Matches,2022
127,Ángel Correa,ar ARG,"FW,MF",Atlético Madrid,26,1995,4.5,7,3,3,2,2,2,12,16.7,10,1,0,1,2,9,1,0,Matches,2022
128,Joaquín Correa,ar ARG,FW,Inter,26,1994,1.2,1,1,1,0,0,1,3,33.3,2,2,0,2,0,1,0,0,Matches,2022
129,Bruno Xavier Almeida Costa,pt POR,MF,Porto,24,1997,0.1,1,1,0,0,1,1,1,100.0,0,0,0,0,0,1,0,0,Matches,2022
130,Diogo Costa,pt POR,GK,Porto,21,1999,6.0,1,1,1,0,0,1,1,100.0,0,0,0,0,0,1,0,2,Matches,2022
131,Fernando Costanza,br BRA,DF,Sheriff Tiraspol,22,1998,6.0,19,12,14,3,2,10,19,52.6,9,13,4,9,11,30,34,0,Matches,2022
132,Thibaut Courtois,be BEL,GK,Real Madrid,29,1992,13.7,0,0,0,0,0,0,0,,0,0,0,0,0,0,3,1,Matches,2022
133,Philippe Coutinho,br BRA,"FW,MF",Barcelona,29,1992,1.2,2,1,0,1,1,2,4,50.0,2,0,0,0,0,2,0,0,Matches,2022
134,Juan Cuadrado,co COL,"DF,MF",Juventus,33,1988,5.2,7,3,5,2,0,4,9,44.4,5,6,1,5,5,12,11,0,Matches,2022
135,Matheus Cunha,br BRA,FW,Atlético Madrid,22,1999,1.6,2,1,1,0,1,0,2,0.0,2,0,0,0,3,5,2,0,Matches,2022
136,Danilo D'Ambrosio,it ITA,DF,Inter,32,1988,1.6,2,1,2,0,0,2,3,66.7,1,1,1,0,1,3,0,0,Matches,2022
137,Cosimo Marco Da Graca,it ITA,FW,Juventus,19,2002,0.0,2,1,0,1,1,0,0,,0,0,0,0,0,2,0,0,Matches,2022
138,Johan Dahlin,se SWE,GK,Malmö,34,1986,3.5,0,0,0,0,0,0,0,,0,0,0,0,0,0,2,0,Matches,2022
139,Mahmoud Dahoud,de GER,MF,Dortmund,25,1996,2.4,7,4,3,2,2,2,9,22.2,7,2,0,2,0,7,0,0,Matches,2022
140,Diogo Dalot,pt POR,DF,Manchester Utd,22,1999,2.6,10,7,7,3,0,7,10,70.0,3,3,0,3,2,12,6,0,Matches,2022
141,Danilo,br BRA,DF,Juventus,30,1991,5.0,9,2,8,1,0,5,9,55.6,4,5,2,3,11,20,19,0,Matches,2022
142,Arnaut Danjuma,nl NED,FW,Villarreal,24,1997,10.0,2,0,0,2,0,0,2,0.0,2,3,0,3,1,3,2,0,Matches,2022
143,Mohammed Daramy,dk DEN,FW,Ajax,19,2002,0.6,0,0,0,0,0,0,0,,0,0,0,0,1,1,1,0,Matches,2022
144,Matteo Darmian,it ITA,DF,Inter,31,1989,2.2,7,3,2,2,3,2,4,50.0,2,4,0,4,2,9,2,0,Matches,2022
145,Jonathan David,ca CAN,FW,Lille,21,2000,7.5,6,2,1,4,1,3,6,50.0,3,7,3,4,3,9,2,0,Matches,2022
146,Alphonso Davies,ca CAN,DF,Bayern Munich,20,2000,5.3,17,10,8,3,6,3,5,60.0,2,6,3,3,6,23,10,0,Matches,2022
147,Kevin De Bruyne,be BEL,MF,Manchester City,30,1991,8.1,7,4,1,6,0,5,17,29.4,12,8,1,7,5,12,1,0,Matches,2022
148,Charles De Ketelaere,be BEL,FW,Club Brugge,20,2001,5.5,8,4,2,5,1,2,4,50.0,2,3,1,2,1,9,2,0,Matches,2022
149,Rodrigo De Paul,ar ARG,MF,Atlético Madrid,27,1994,6.4,19,12,5,8,6,12,26,46.2,14,13,2,11,7,26,11,0,Matches,2022
150,Mattia De Sciglio,it ITA,DF,Juventus,28,1992,3.2,11,8,7,4,0,7,11,63.6,4,1,0,1,7,18,2,0,Matches,2022
151,Koni De Winter,be BEL,DF,Juventus,19,2002,0.9,1,0,0,1,0,0,0,,0,0,0,0,0,1,0,0,Matches,2022
152,Thomas Delaney,dk DEN,MF,Sevilla,29,1991,2.2,6,5,5,1,0,2,5,40.0,3,3,2,1,6,12,3,0,Matches,2022
153,Liam Delap,eng ENG,FW,Manchester City,18,2003,0.1,0,0,0,0,0,0,0,,0,0,0,0,0,0,0,0,Matches,2022
154,Ousmane Dembélé,fr FRA,"FW,DF",Barcelona,24,1997,1.4,0,0,0,0,0,0,2,0.0,2,0,0,0,0,0,0,0,Matches,2022
155,Yusuf Demir,at AUT,"DF,FW",Barcelona,18,2003,1.1,2,1,1,1,0,0,4,0.0,4,1,0,1,0,2,0,0,Matches,2022
156,Merih Demiral,tr TUR,DF,Atalanta,23,1998,4.1,8,4,7,1,0,5,9,55.6,4,4,3,1,9,17,20,1,Matches,2022
157,Dentinho,br BRA,FW,Shakhtar,32,1989,0.1,0,0,0,0,0,0,0,,0,0,0,0,0,0,0,0,Matches,2022
158,Sergiño Dest,us USA,"DF,FW",Barcelona,20,2000,2.6,11,6,4,4,3,3,5,60.0,2,3,0,3,1,12,0,0,Matches,2022
159,Ersin Destanoğlu,tr TUR,GK,Beşiktaş,20,2001,5.0,0,0,0,0,0,0,0,,0,0,0,0,0,0,3,0,Matches,2022
160,Ángel Di María,ar ARG,FW,Paris S-G,33,1988,2.9,6,2,2,4,0,4,9,44.4,5,5,0,5,0,6,1,0,Matches,2022
161,Boulaye Dia,sn SEN,FW,Villarreal,24,1996,2.9,1,0,1,0,0,1,2,50.0,1,2,0,2,1,2,3,0,Matches,2022
162,Abdou Diallo,sn SEN,DF,Paris S-G,25,1996,1.8,6,2,5,1,0,1,3,33.3,2,6,3,3,5,11,9,0,Matches,2022
163,Amad Diallo,ci CIV,MF,Manchester Utd,19,2002,0.7,1,1,0,1,0,0,1,0.0,1,3,0,3,1,2,0,0,Matches,2022
164,Rúben Dias,pt POR,DF,Manchester City,24,1997,7.4,11,2,8,3,0,8,11,72.7,3,9,4,5,8,19,15,0,Matches,2022
165,Ismael Diawara,ml MLI,GK,Malmö,26,1994,2.5,0,0,0,0,0,0,0,,0,0,0,0,0,0,2,0,Matches,2022
166,Brahim Díaz,es ESP,MF,Milan,21,1999,3.9,3,0,0,3,0,0,3,0.0,3,2,0,2,0,3,2,0,Matches,2022
167,Luis Díaz,co COL,"MF,FW",Porto,24,1997,5.8,8,4,3,1,4,1,4,25.0,3,4,0,4,3,11,1,0,Matches,2022
168,Luis Díaz,co COL,FW,Liverpool,24,1997,4.3,2,0,1,1,0,0,6,0.0,6,5,0,5,0,2,0,0,Matches,2022
169,Federico Dimarco,it ITA,DF,Inter,23,1997,3.1,7,4,1,6,0,3,8,37.5,5,2,1,1,3,10,5,0,Matches,2022
170,Junior Dina Ebimbe,fr FRA,MF,Paris S-G,20,2000,0.1,0,0,0,0,0,0,0,,0,0,0,0,0,0,0,0,Matches,2022
171,Tiago Djaló,pt POR,DF,Lille,21,2000,5.9,12,5,7,5,0,6,7,85.7,1,8,3,5,6,18,20,0,Matches,2022
172,Berat Djimsiti,al ALB,DF,Atalanta,28,1993,2.9,4,4,1,1,2,0,2,0.0,2,3,1,2,7,11,5,0,Matches,2022
173,Dodô,br BRA,DF,Shakhtar,22,1998,6.0,13,9,11,2,0,8,9,88.9,1,7,2,5,5,18,7,1,Matches,2022
174,Gianluigi Donnarumma,it ITA,GK,Paris S-G,22,1999,5.0,0,0,0,0,0,0,0,,0,0,0,0,0,0,6,1,Matches,2022
175,Bas Dost,nl NED,FW,Club Brugge,32,1989,0.8,0,0,0,0,0,0,0,,0,1,0,1,0,0,2,0,Matches,2022
176,Julian Draxler,de GER,"MF,FW",Paris S-G,27,1993,1.6,2,0,0,1,1,1,4,25.0,3,1,0,1,1,3,2,0,Matches,2022
177,Rodrigo Duarte,pt POR,FW,Sporting CP,16,2005,0.0,0,0,0,0,0,0,0,,0,0,0,0,0,0,0,0,Matches,2022
178,Gustavo Dulanto,pe PER,DF,Sheriff Tiraspol,25,1995,6.0,17,10,13,4,0,12,15,80.0,3,14,10,4,6,23,32,0,Matches,2022
179,Denzel Dumfries,nl NED,DF,Inter,25,1996,5.2,3,2,2,1,0,1,3,33.3,2,1,0,1,6,9,5,0,Matches,2022
180,Paulo Dybala,ar ARG,"FW,MF",Juventus,27,1993,2.8,3,1,0,0,3,1,5,20.0,4,1,0,1,0,3,0,0,Matches,2022
181,Edin Džeko,ba BIH,FW,Inter,35,1986,6.0,0,0,0,0,0,0,1,0.0,1,3,2,1,2,2,7,0,Matches,2022
182,Artem Dzyuba,ru RUS,FW,Zenit,32,1988,3.1,0,0,0,0,0,0,1,0.0,1,3,0,3,1,1,6,0,Matches,2022
183,Ederson,br BRA,GK,Manchester City,27,1993,11.1,0,0,0,0,0,0,0,,0,1,0,1,1,1,3,0,Matches,2022
184,Marcus Edwards,eng ENG,MF,Sporting CP,22,1998,0.4,1,1,0,1,0,0,0,,0,0,0,0,0,1,0,0,Matches,2022
185,CJ Egan-Riley,eng ENG,DF,Manchester City,18,2003,1.0,0,0,0,0,0,0,0,,0,0,0,0,0,0,2,0,Matches,2022
186,Noah Eile,se SWE,DF,Malmö,19,2002,0.0,0,0,0,0,0,0,0,,0,0,0,0,0,0,1,0,Matches,2022
187,Anthony Elanga,se SWE,"FW,MF",Manchester Utd,19,2002,1.9,4,3,1,3,0,2,2,100.0,0,0,0,0,3,7,0,0,Matches,2022
188,Meschak Elia,cd COD,FW,Young Boys,23,1997,5.4,6,2,1,2,3,2,3,66.7,1,0,0,0,4,10,0,0,Matches,2022
189,Harvey Elliott,eng ENG,MF,Liverpool,18,2003,0.6,1,0,0,0,1,1,1,100.0,0,0,0,0,0,1,0,0,Matches,2022
190,Youssef En-Nesyri,ma MAR,FW,Sevilla,24,1997,0.9,0,0,0,0,0,0,0,,0,0,0,0,0,0,1,0,Matches,2022
191,Aleksandr Erokhin,ru RUS,MF,Zenit,31,1989,1.2,1,1,1,0,0,0,1,0.0,1,2,0,2,0,1,1,0,Matches,2022
192,Ricardo Esgaio,pt POR,DF,Sporting CP,28,1993,4.3,11,5,5,5,1,6,12,50.0,6,11,2,9,3,14,5,0,Matches,2022
193,Dario Essugo,pt POR,MF,Sporting CP,16,2005,0.1,0,0,0,0,0,0,0,,0,1,1,0,1,1,0,0,Matches,2022
194,Gonçalo Esteves,pt POR,DF,Sporting CP,17,2004,0.8,2,2,1,0,1,0,0,,0,0,0,0,1,3,0,0,Matches,2022
195,Pervis Estupiñán,ec ECU,DF,Villarreal,23,1998,7.2,19,9,15,2,2,5,12,41.7,7,7,2,5,10,29,30,0,Matches,2022
196,Evanilson,br BRA,FW,Porto,21,1999,3.4,2,0,1,0,1,2,3,66.7,1,4,0,4,0,2,4,0,Matches,2022
197,Fabinho,br BRA,MF,Liverpool,27,1993,9.4,30,18,6,18,6,16,24,66.7,8,17,0,17,18,48,4,0,Matches,2022
198,Guillaume Faivre,ch SUI,GK,Young Boys,34,1987,3.0,0,0,0,0,0,0,0,,0,0,0,0,0,0,2,0,Matches,2022
199,Christian Fassnacht,ch SUI,"MF,FW",Young Boys,27,1993,3.0,5,3,1,4,0,2,5,40.0,3,3,0,3,7,12,0,0,Matches,2022
200,Ansu Fati,es ESP,FW,Barcelona,18,2002,1.7,1,1,0,1,0,1,2,50.0,1,2,0,2,1,2,0,0,Matches,2022
201,Zouhair Feddal,ma MAR,DF,Sporting CP,32,1989,5.0,7,3,4,2,1,3,5,60.0,2,4,0,4,13,20,18,1,Matches,2022
202,Felipe,br BRA,DF,Atlético Madrid,32,1989,5.2,2,2,2,0,0,1,3,33.3,2,8,4,4,4,6,24,0,Matches,2022
203,João Félix,pt POR,"FW,MF",Atlético Madrid,21,1999,6.3,3,0,1,1,1,2,8,25.0,6,2,0,2,8,11,8,0,Matches,2022
204,Bruno Fernandes,pt POR,MF,Manchester Utd,26,1994,5.8,12,7,2,9,1,8,17,47.1,9,5,0,5,2,14,8,0,Matches,2022
205,Fernandinho,br BRA,"MF,DF",Manchester City,36,1985,3.9,9,6,1,7,1,2,4,50.0,2,2,2,0,9,18,1,1,Matches,2022
206,Fernando,br BRA,MF,Sevilla,34,1987,6.0,5,3,2,3,0,3,9,33.3,6,7,2,5,15,20,5,0,Matches,2022
207,Fernando,br BRA,FW,Shakhtar,22,1999,3.8,8,8,2,2,4,3,8,37.5,5,1,0,1,2,10,1,0,Matches,2022
208,Roberto Firmino,br BRA,FW,Liverpool,29,1991,3.6,13,8,1,8,4,4,9,44.4,5,4,0,4,2,15,1,0,Matches,2022
209,Alessandro Florenzi,it ITA,"DF,FW",Milan,30,1991,1.0,3,0,3,0,0,1,3,33.3,2,0,0,0,2,5,4,0,Matches,2022
210,Phil Foden,eng ENG,FW,Manchester City,21,2000,7.3,6,4,2,4,0,6,10,60.0,4,8,0,8,2,8,0,0,Matches,2022
211,José Fonte,pt POR,DF,Lille,37,1983,8.0,9,4,6,3,0,4,6,66.7,2,7,1,6,8,17,31,0,Matches,2022
212,Emil Forsberg,se SWE,"MF,FW",RB Leipzig,29,1991,4.3,3,2,0,1,2,2,12,16.7,10,6,0,6,2,5,2,0,Matches,2022
213,Juan Foyth,ar ARG,DF,Villarreal,23,1998,9.9,37,25,25,10,2,17,42,40.5,25,13,6,7,12,49,24,2,Matches,2022
214,Lassina Franck Traoré,bf BFA,FW,Shakhtar,20,2001,1.1,0,0,0,0,0,0,1,0.0,1,0,0,0,0,0,1,0,Matches,2022
215,Fred,br BRA,MF,Manchester Utd,28,1993,4.8,13,7,4,7,2,5,13,38.5,8,4,1,3,7,20,4,0,Matches,2022
216,Remo Freuler,ch SUI,MF,Atalanta,29,1992,5.8,8,1,4,4,0,4,10,40.0,6,9,2,7,7,15,8,0,Matches,2022
217,Roberto Gagliardini,it ITA,MF,Inter,27,1994,0.8,4,2,4,0,0,2,2,100.0,0,2,0,2,1,5,3,0,Matches,2022
218,Idrissa Gana Gueye,sn SEN,MF,Paris S-G,31,1989,4.4,14,8,9,2,3,2,6,33.3,4,5,1,4,7,21,6,0,Matches,2022
219,Eric García,es ESP,DF,Barcelona,20,2001,2.7,4,2,3,1,0,2,4,50.0,2,2,1,1,5,9,5,0,Matches,2022
220,Ulisses Garcia,ch SUI,DF,Young Boys,25,1996,4.8,12,10,9,3,0,9,12,75.0,3,2,0,2,6,18,7,0,Matches,2022
221,Mario Gaspar,es ESP,DF,Villarreal,30,1990,1.0,2,2,1,0,1,1,1,100.0,0,1,0,1,0,2,1,0,Matches,2022
222,Gavi,es ESP,"MF,FW",Barcelona,16,2004,4.4,10,6,1,6,3,5,12,41.7,7,5,0,5,3,13,1,0,Matches,2022
223,David de Gea,es ESP,GK,Manchester Utd,30,1990,7.0,0,0,0,0,0,0,0,,0,0,0,0,0,0,0,1,Matches,2022
224,Yannick Gerhardt,de GER,FW,Wolfsburg,27,1994,2.1,6,5,3,3,0,3,5,60.0,2,1,0,1,0,6,0,0,Matches,2022
225,Rachid Ghezzal,dz ALG,"FW,MF",Beşiktaş,29,1992,3.8,5,4,2,3,0,2,18,11.1,16,3,0,3,5,10,1,0,Matches,2022
226,Gilberto,br BRA,"DF,MF",Benfica,28,1993,7.9,25,16,17,7,1,16,28,57.1,12,12,2,10,21,46,18,0,Matches,2022
227,Daniel Ginczek,de GER,FW,Wolfsburg,30,1991,0.0,0,0,0,0,0,0,0,,0,0,0,0,0,0,0,0,Matches,2022
228,Olivier Giroud,fr FRA,FW,Milan,34,1986,2.9,2,2,1,0,1,0,1,0.0,1,0,0,0,2,4,3,0,Matches,2022
229,Serge Gnabry,de GER,"FW,MF",Bayern Munich,26,1995,4.3,7,4,1,4,2,3,5,60.0,2,6,1,5,4,11,0,0,Matches,2022
230,Angel Gomes,eng ENG,MF,Lille,20,2000,1.9,6,5,1,2,3,4,9,44.4,5,3,1,2,1,7,1,0,Matches,2022
231,Joe Gomez,eng ENG,DF,Liverpool,24,1997,2.8,4,1,1,2,1,3,3,100.0,0,2,1,1,7,11,6,0,Matches,2022
232,Moi Gómez,es ESP,"MF,FW",Villarreal,27,1994,2.5,6,2,2,3,1,3,6,50.0,3,0,0,0,0,6,4,0,Matches,2022
233,Papu Gómez,ar ARG,"FW,MF",Sevilla,33,1988,3.6,2,1,1,0,1,0,3,0.0,3,5,0,5,0,2,1,0,Matches,2022
234,Diogo Gonçalves,pt POR,"MF,FW",Benfica,24,1997,1.5,0,0,0,0,0,0,4,0.0,4,2,0,2,2,2,6,0,Matches,2022
235,Pedro Gonçalves,pt POR,MF,Sporting CP,23,1998,3.6,6,4,0,4,2,2,9,22.2,7,4,0,4,3,9,0,0,Matches,2022
236,Nicolás González,es ESP,MF,Barcelona,19,2002,2.8,4,1,1,2,1,2,6,33.3,4,4,0,4,3,7,2,0,Matches,2022
237,Leon Goretzka,de GER,MF,Bayern Munich,26,1995,5.2,12,8,4,6,2,6,13,46.2,7,6,2,4,7,19,5,0,Matches,2022
238,Robin Gosens,de GER,DF,Atalanta,27,1994,1.1,1,0,1,0,0,1,2,50.0,1,1,1,0,3,4,1,0,Matches,2022
239,Ryan Gravenberch,nl NED,MF,Ajax,19,2002,7.8,14,8,4,7,3,4,15,26.7,11,6,1,5,6,20,12,0,Matches,2022
240,Ivo Grbić,hr CRO,GK,Lille,25,1996,6.0,0,0,0,0,0,0,0,,0,0,0,0,0,0,1,1,Matches,2022
241,Jack Grealish,eng ENG,FW,Manchester City,25,1995,5.1,9,3,4,2,3,3,4,75.0,1,3,0,3,3,12,1,0,Matches,2022
242,Mason Greenwood,eng ENG,FW,Manchester Utd,19,2001,3.4,5,2,2,0,3,3,7,42.9,4,4,0,4,2,7,2,0,Matches,2022
243,Antoine Griezmann,fr FRA,"FW,MF",Atlético Madrid,30,1991,5.7,15,8,5,9,1,7,17,41.2,10,5,0,5,4,19,5,0,Matches,2022
244,Álex Grimaldo,es ESP,"DF,MF",Benfica,25,1995,9.6,20,12,18,2,0,12,29,41.4,17,13,7,6,7,27,21,0,Matches,2022
245,Marko Grujić,rs SRB,MF,Porto,25,1996,3.6,8,6,4,3,1,4,7,57.1,3,2,0,2,2,10,6,0,Matches,2022
246,Gabriel Gudmundsson,se SWE,"MF,DF",Lille,22,1999,2.7,7,4,5,0,2,2,6,33.3,4,6,1,5,2,9,2,0,Matches,2022
247,Raphaël Guerreiro,pt POR,DF,Dortmund,27,1993,2.0,5,3,2,2,1,1,2,50.0,1,1,0,1,0,5,3,0,Matches,2022
248,Josuha Guilavogui,fr FRA,"MF,DF",Wolfsburg,30,1990,4.7,8,6,4,4,0,4,9,44.4,5,8,5,3,15,23,18,0,Matches,2022
249,Daouda Guindo,ml MLI,DF,RB Salzburg,18,2002,0.1,0,0,0,0,0,0,0,,0,0,0,0,1,1,0,0,Matches,2022
250,Péter Gulácsi,hu HUN,GK,RB Leipzig,31,1990,5.0,0,0,0,0,0,0,0,,0,1,0,1,1,1,0,0,Matches,2022
251,İlkay Gündoğan,de GER,MF,Manchester City,30,1990,7.4,7,4,2,5,0,2,7,28.6,5,8,1,7,7,14,1,0,Matches,2022
252,Mert Günok,tr TUR,GK,Beşiktaş,32,1989,1.0,0,0,0,0,0,0,0,,0,0,0,0,0,0,0,0,Matches,2022
253,Miguel Gutiérrez,es ESP,DF,Real Madrid,20,2001,0.7,1,0,1,0,0,1,1,100.0,0,0,0,0,0,1,0,0,Matches,2022
254,Joško Gvardiol,hr CRO,DF,RB Leipzig,19,2002,3.7,5,4,3,1,1,4,6,66.7,2,6,3,3,8,13,11,0,Matches,2022
255,Erling Haaland,no NOR,FW,Dortmund,21,2000,2.3,0,0,0,0,0,0,2,0.0,2,1,0,1,0,0,5,0,Matches,2022
256,Munir El Haddadi,ma MAR,"FW,MF",Sevilla,25,1995,2.3,0,0,0,0,0,0,1,0.0,1,1,0,1,1,1,0,0,Matches,2022
257,Amadou Haidara,ml MLI,MF,RB Leipzig,23,1998,2.0,10,4,4,4,2,4,7,57.1,3,2,0,2,3,13,1,0,Matches,2022
258,Achraf Hakimi,ma MAR,DF,Paris S-G,22,1998,8.0,16,6,11,3,2,12,28,42.9,16,13,2,11,5,21,15,0,Matches,2022
259,Sébastien Haller,ci CIV,FW,Ajax,27,1994,7.4,3,0,2,0,1,1,3,33.3,2,5,0,5,1,4,4,0,Matches,2022
260,Samir Handanović,si SVN,GK,Inter,37,1984,8.0,1,1,1,0,0,0,0,,0,0,0,0,0,1,1,0,Matches,2022
261,Denys Harmash,ua UKR,FW,Dynamo Kyiv,31,1990,3.6,9,3,4,2,3,2,8,25.0,6,2,0,2,3,12,1,0,Matches,2022
262,Hans Hateboer,nl NED,DF,Atalanta,27,1994,1.0,2,1,1,0,1,2,2,100.0,0,0,0,0,1,3,2,0,Matches,2022
263,Kai Havertz,de GER,"FW,MF",Chelsea,22,1999,7.5,5,2,0,2,3,1,5,20.0,4,7,0,7,3,8,6,0,Matches,2022
264,Eden Hazard,be BEL,FW,Real Madrid,30,1991,0.9,1,1,0,1,0,1,3,33.3,2,1,0,1,0,1,0,0,Matches,2022
265,Thorgan Hazard,be BEL,FW,Dortmund,28,1993,1.6,2,1,1,1,0,1,1,100.0,0,3,0,3,2,4,1,0,Matches,2022
266,Tom Heaton,eng ENG,GK,Manchester Utd,35,1986,0.3,0,0,0,0,0,0,0,,0,0,0,0,0,0,0,0,Matches,2022
267,Silvan Hefti,ch SUI,DF,Young Boys,23,1997,4.3,9,5,7,2,0,6,12,50.0,6,8,4,4,5,14,8,0,Matches,2022
268,Dean Henderson,eng ENG,GK,Manchester Utd,24,1997,0.7,0,0,0,0,0,0,0,,0,0,0,0,0,0,2,0,Matches,2022
269,Jordan Henderson,eng ENG,MF,Liverpool,31,1990,7.4,12,5,7,3,2,6,11,54.5,5,9,2,7,13,25,3,0,Matches,2022
270,Jack Hendry,sct SCO,DF,Club Brugge,26,1995,6.0,8,5,5,2,1,1,3,33.3,2,10,7,3,4,12,16,0,Matches,2022
271,Benjamin Henrichs,de GER,DF,RB Leipzig,24,1997,0.6,2,0,0,0,2,2,3,66.7,1,0,0,0,3,5,2,0,Matches,2022
272,Mario Hermoso,es ESP,DF,Atlético Madrid,26,1995,4.7,11,5,10,0,1,8,13,61.5,5,2,2,0,10,21,23,0,Matches,2022
273,Lucas Hernández,fr FRA,DF,Bayern Munich,25,1996,6.3,16,10,8,6,2,9,11,81.8,2,8,2,6,10,26,10,0,Matches,2022
274,Theo Hernández,fr FRA,DF,Milan,23,1997,5.0,6,5,6,0,0,3,6,50.0,3,2,2,0,3,9,12,0,Matches,2022
275,Ander Herrera,es ESP,MF,Paris S-G,31,1989,3.6,11,6,7,3,1,4,14,28.6,10,5,2,3,7,18,4,0,Matches,2022
276,Héctor Herrera,mx MEX,MF,Atlético Madrid,31,1990,2.5,6,4,4,2,0,3,5,60.0,2,7,1,6,1,7,2,0,Matches,2022
277,Callum Hudson-Odoi,eng ENG,"MF,DF",Chelsea,20,2000,3.2,6,3,1,2,3,1,4,25.0,3,5,0,5,1,7,0,0,Matches,2022
278,Mats Hummels,de GER,DF,Dortmund,32,1988,3.9,14,9,9,5,0,5,6,83.3,1,7,3,4,7,21,17,0,Matches,2022
279,Atiba Hutchinson,ca CAN,MF,Beşiktaş,38,1983,1.7,3,2,2,1,0,1,4,25.0,3,2,0,2,1,4,0,0,Matches,2022
280,Vicente Iborra,es ESP,MF,Villarreal,33,1988,0.1,0,0,0,0,0,0,0,,0,0,0,0,2,2,0,0,Matches,2022
281,Zlatan Ibrahimović,se SWE,FW,Milan,39,1981,1.8,2,1,0,2,0,0,0,,0,0,0,0,0,2,1,1,Matches,2022
282,Mauro Icardi,ar ARG,FW,Paris S-G,28,1993,0.5,0,0,0,0,0,0,1,0.0,1,0,0,0,0,0,1,0,Matches,2022
283,Jonathan Ikone,fr FRA,MF,Lille,23,1998,3.3,2,1,1,0,1,1,2,50.0,1,3,0,3,0,2,1,0,Matches,2022
284,Josip Iličić,si SVN,"FW,MF",Atalanta,33,1988,2.8,0,0,0,0,0,0,2,0.0,2,2,1,1,1,1,0,1,Matches,2022
285,Gonçalo Inácio,pt POR,DF,Sporting CP,19,2001,6.2,5,2,5,0,0,0,6,0.0,6,7,6,1,9,14,25,1,Matches,2022
286,Jo Inge Berget,no NOR,DF,Malmö,30,1990,4.9,7,3,5,2,0,2,5,40.0,3,3,0,3,3,10,11,0,Matches,2022
287,Bonke Innocent,ng NGA,MF,Malmö,25,1996,5.5,10,6,5,5,0,5,18,27.8,13,9,1,8,5,15,8,1,Matches,2022
288,Zidane Iqbal,iq IRQ,MF,Manchester Utd,18,2003,0.0,0,0,0,0,0,0,0,,0,0,0,0,0,0,0,0,Matches,2022
289,Ismaily,br BRA,DF,Shakhtar,31,1990,3.9,6,3,2,3,1,0,3,0.0,3,8,4,4,5,11,14,0,Matches,2022
290,José Izquierdo,co COL,DF,Club Brugge,29,1992,0.1,0,0,0,0,0,0,0,,0,0,0,0,0,0,0,0,Matches,2022
291,Reece James,eng ENG,"DF,MF",Chelsea,21,1999,5.6,14,8,10,3,1,7,7,100.0,0,2,0,2,7,21,6,0,Matches,2022
292,Léo Jardim,br BRA,GK,Lille,26,1995,2.0,0,0,0,0,0,0,0,,0,0,0,0,0,0,0,0,Matches,2022
293,Gabriel Jesus,br BRA,FW,Manchester City,24,1997,3.9,5,2,1,2,2,1,2,50.0,1,5,0,5,2,7,1,0,Matches,2022
294,Curtis Jones,eng ENG,"MF,FW",Liverpool,20,2001,2.1,2,1,0,1,1,2,2,100.0,0,2,0,2,0,2,1,0,Matches,2022
295,Frenkie de Jong,nl NED,MF,Barcelona,24,1997,5.8,13,4,5,6,2,5,9,55.6,4,1,0,1,5,18,4,0,Matches,2022
296,Luuk de Jong,nl NED,FW,Barcelona,30,1990,2.0,0,0,0,0,0,0,1,0.0,1,3,1,2,1,1,0,0,Matches,2022
297,Joan Jordán,es ESP,"MF,FW",Sevilla,27,1994,3.6,5,3,2,3,0,5,14,35.7,9,3,1,2,3,8,1,0,Matches,2022
298,Jorginho,it ITA,MF,Chelsea,29,1991,6.2,22,6,6,11,5,9,14,64.3,5,8,0,8,13,35,1,2,Matches,2022
299,Diogo Jota,pt POR,FW,Liverpool,24,1996,6.4,8,5,4,3,1,2,8,25.0,6,5,0,5,6,14,3,0,Matches,2022
300,Luka Jović,rs SRB,FW,Real Madrid,23,1997,1.3,0,0,0,0,0,0,0,,0,0,0,0,0,0,0,0,Matches,2022
301,Keston Julien,tt TRI,FW,Sheriff Tiraspol,22,1998,0.6,0,0,0,0,0,0,0,,0,0,0,0,0,0,2,0,Matches,2022
302,Vinicius Júnior,br BRA,FW,Real Madrid,21,2000,13.3,21,11,7,7,7,6,17,35.3,11,10,0,10,2,23,1,0,Matches,2022
303,Pierre Kalulu,fr FRA,DF,Milan,21,2000,2.4,7,3,6,1,0,2,3,66.7,1,1,1,0,3,10,2,0,Matches,2022
304,Kevin Kampl,si SVN,MF,RB Leipzig,30,1990,3.0,6,4,3,3,0,1,5,20.0,4,5,2,3,6,12,2,0,Matches,2022
305,Wilfried Kanga,ci CIV,FW,Young Boys,23,1998,0.9,0,0,0,0,0,0,1,0.0,1,0,0,0,0,0,0,0,Matches,2022
306,N'Golo Kanté,fr FRA,MF,Chelsea,30,1991,4.7,10,5,3,5,2,2,9,22.2,7,9,1,8,5,15,2,0,Matches,2022
307,Kenan Karaman,tr TUR,"FW,MF",Beşiktaş,27,1994,3.0,3,2,3,0,0,1,6,16.7,5,0,0,0,1,4,1,0,Matches,2022
308,Oleksandr Karavayev,ua UKR,"DF,MF",Dynamo Kyiv,29,1992,1.8,2,0,1,1,0,2,2,100.0,0,2,1,1,1,3,6,0,Matches,2022
309,Vyacheslav Karavayev,ru RUS,DF,Zenit,26,1995,3.3,6,4,4,2,0,4,9,44.4,5,3,1,2,1,7,7,0,Matches,2022
310,Moise Kean,it ITA,FW,Juventus,21,2000,1.9,3,3,1,0,2,2,5,40.0,3,0,0,0,1,4,1,0,Matches,2022
311,Tomasz Kędziora,pl POL,DF,Dynamo Kyiv,27,1994,4.0,8,5,6,2,0,2,4,50.0,2,5,3,2,5,13,8,0,Matches,2022
312,Thilo Kehrer,de GER,DF,Paris S-G,24,1996,0.7,0,0,0,0,0,0,0,,0,1,0,1,0,0,4,0,Matches,2022
313,Naby Keïta,gn GUI,MF,Liverpool,26,1995,5.4,15,8,4,9,2,6,18,33.3,12,12,0,12,3,18,7,0,Matches,2022
314,Mikhail Kerzhakov,ru RUS,GK,Zenit,34,1987,2.0,0,0,0,0,0,0,0,,0,0,0,0,0,0,0,1,Matches,2022
315,Franck Kessié,ci CIV,MF,Milan,24,1996,3.6,4,2,2,2,0,2,5,40.0,3,6,1,5,5,9,4,0,Matches,2022
316,Joshua Kimmich,de GER,MF,Bayern Munich,26,1995,7.8,19,11,8,8,3,8,18,44.4,10,5,0,5,16,35,8,0,Matches,2022
317,Presnel Kimpembe,fr FRA,DF,Paris S-G,25,1995,7.0,11,9,8,3,0,7,8,87.5,1,9,8,1,5,16,31,0,Matches,2022
318,Simon Kjær,dk DEN,DF,Milan,32,1989,3.0,5,1,2,3,0,4,9,44.4,5,5,4,1,3,8,16,0,Matches,2022
319,Maurits Kjærgaard,dk DEN,"FW,MF",RB Salzburg,18,2003,0.5,1,0,0,1,0,1,2,50.0,1,0,0,0,0,1,0,0,Matches,2022
320,Davy Klaassen,nl NED,MF,Ajax,28,1993,2.6,7,6,2,2,3,3,9,33.3,6,4,1,3,2,9,1,0,Matches,2022
321,Lukas Klostermann,de GER,DF,RB Leipzig,25,1996,3.9,7,3,6,1,0,3,5,60.0,2,7,4,3,8,15,11,0,Matches,2022
322,Ansgar Knauff,de GER,"FW,MF",Dortmund,19,2002,0.3,3,2,1,2,0,1,3,33.3,2,0,0,0,1,4,0,0,Matches,2022
323,Gregor Kobel,ch SUI,GK,Dortmund,23,1997,6.0,1,0,1,0,0,1,1,100.0,0,0,0,0,0,1,1,0,Matches,2022
324,Philipp Köhn,ch SUI,GK,RB Salzburg,23,1998,8.0,0,0,0,0,0,0,0,,0,0,0,0,0,0,3,1,Matches,2022
325,Koke,es ESP,MF,Atlético Madrid,29,1992,7.3,14,9,9,5,0,8,27,29.6,19,5,0,5,5,19,4,0,Matches,2022
326,Aleksandar Kolarov,rs SRB,DF,Inter,35,1985,0.1,0,0,0,0,0,0,0,,0,0,0,0,0,0,0,0,Matches,2022
327,Dimitris Kolovos,gr GRE,"MF,FW",Sheriff Tiraspol,28,1993,4.5,4,2,1,1,2,3,12,25.0,9,3,1,2,0,4,0,0,Matches,2022
328,Ibrahima Konaté,fr FRA,DF,Liverpool,22,1999,8.0,16,11,13,2,1,10,15,66.7,5,10,4,6,13,29,24,1,Matches,2022
329,Geoffrey Kondogbia,cf CTA,"MF,DF",Atlético Madrid,28,1993,6.4,20,16,10,10,0,7,16,43.8,9,4,2,2,14,34,3,0,Matches,2022
330,Teun Koopmeiners,nl NED,MF,Atalanta,23,1998,2.4,5,2,3,1,1,1,3,33.3,2,5,2,3,0,5,1,0,Matches,2022
331,Viktor Korniienko,ua UKR,DF,Shakhtar,22,1999,0.9,0,0,0,0,0,0,0,,0,0,0,0,1,1,1,0,Matches,2022
332,Jules Koundé,fr FRA,DF,Sevilla,22,1998,5.0,4,4,2,2,0,1,3,33.3,2,2,2,0,9,13,15,0,Matches,2022
333,Mateo Kovačić,hr CRO,MF,Chelsea,27,1994,4.7,13,7,5,8,0,5,10,50.0,5,6,0,6,0,13,1,1,Matches,2022
334,Kirill Kravtsov,ru RUS,MF,Zenit,19,2002,0.2,0,0,0,0,0,0,1,0.0,1,0,0,0,0,0,0,0,Matches,2022
335,Stanislav Kritsyuk,ru RUS,GK,Zenit,30,1990,4.0,0,0,0,0,0,0,0,,0,0,0,0,0,0,5,0,Matches,2022
336,Toni Kroos,de GER,MF,Real Madrid,31,1990,10.0,23,14,9,13,1,7,22,31.8,15,6,2,4,6,29,3,0,Matches,2022
337,Danil Krugovoy,ru RUS,"DF,MF",Zenit,23,1998,0.8,1,1,0,1,0,1,1,100.0,0,0,0,0,1,2,0,1,Matches,2022
338,Rade Krunić,ba BIH,"FW,MF",Milan,27,1993,2.8,2,2,2,0,0,1,2,50.0,1,8,3,5,3,5,3,0,Matches,2022
339,Serhiy Kryvtsov,ua UKR,DF,Shakhtar,30,1991,2.1,2,2,1,0,1,2,4,50.0,2,0,0,0,3,5,10,0,Matches,2022
340,Dejan Kulusevski,se SWE,"FW,MF",Juventus,21,2000,0.9,2,1,1,1,0,0,2,0.0,2,0,0,0,0,2,1,0,Matches,2022
341,Daniil Kuznetsov,ru RUS,MF,Zenit,18,2003,0.0,0,0,0,0,0,0,0,,0,0,0,0,0,0,0,0,Matches,2022
342,Daler Kuzyaev,ru RUS,MF,Zenit,28,1993,2.8,5,4,2,2,1,1,4,25.0,3,4,1,3,3,8,3,0,Matches,2022
343,Maxence Lacroix,fr FRA,DF,Wolfsburg,21,2000,6.0,8,4,7,1,0,5,7,71.4,2,6,3,3,14,22,25,0,Matches,2022
344,Konrad Laimer,at AUT,MF,RB Leipzig,24,1997,4.5,13,7,5,3,5,1,21,4.8,20,10,0,10,7,20,0,0,Matches,2022
345,Érik Lamela,ar ARG,"FW,MF",Sevilla,29,1992,1.4,6,2,4,0,2,3,6,50.0,3,2,1,1,0,6,2,0,Matches,2022
346,Noa Lang,nl NED,"MF,FW",Club Brugge,22,1999,5.9,8,5,2,4,2,2,2,100.0,0,5,0,5,4,12,2,0,Matches,2022
347,Aymeric Laporte,es ESP,DF,Manchester City,27,1994,8.8,12,7,8,4,0,7,9,77.8,2,4,2,2,11,23,20,0,Matches,2022
348,Cyle Larin,ca CAN,"FW,MF",Beşiktaş,26,1995,3.9,6,4,2,4,0,1,7,14.3,6,4,0,4,1,7,4,0,Matches,2022
349,Eric Larsson,se SWE,DF,Malmö,30,1991,3.1,0,0,0,0,0,0,4,0.0,4,0,0,0,2,2,6,0,Matches,2022
350,Sandro Lauper,ch SUI,DF,Young Boys,24,1996,5.1,13,7,11,2,0,8,11,72.7,3,2,1,1,8,21,9,0,Matches,2022
351,Valentino Lazaro,at AUT,"DF,MF",Benfica,25,1996,1.3,5,4,3,2,0,3,4,75.0,1,0,0,0,0,5,3,0,Matches,2022
352,Rafael Leão,pt POR,FW,Milan,22,1999,3.2,6,3,1,5,0,4,6,66.7,2,2,0,2,1,7,4,0,Matches,2022
353,Jordan Lefort,fr FRA,DF,Young Boys,27,1993,1.9,5,3,4,1,0,3,6,50.0,3,1,0,1,5,10,5,0,Matches,2022
354,Thomas Lemar,fr FRA,MF,Atlético Madrid,25,1995,4.2,6,4,0,5,1,0,4,0.0,4,2,0,2,6,12,3,0,Matches,2022
355,Clément Lenglet,fr FRA,DF,Barcelona,26,1995,3.8,6,3,2,4,0,3,5,60.0,2,1,1,0,5,11,2,0,Matches,2022
356,Robert Lewandowski,pl POL,FW,Bayern Munich,32,1988,9.7,4,2,0,3,1,2,6,33.3,4,5,0,5,1,5,2,0,Matches,2022
357,Oscar Lewicki,se SWE,MF,Malmö,29,1992,1.4,0,0,0,0,0,0,0,,0,1,0,1,0,0,2,0,Matches,2022
358,Bohdan Liedniev,ua UKR,MF,Dynamo Kyiv,23,1998,0.1,0,0,0,0,0,0,1,0.0,1,0,0,0,0,0,0,0,Matches,2022
359,Matthijs de Ligt,nl NED,DF,Juventus,21,1999,6.9,7,5,6,1,0,5,7,71.4,2,4,2,2,9,16,23,0,Matches,2022
360,Isaac Lihadji,fr FRA,"MF,FW",Lille,19,2002,0.3,1,0,1,0,0,0,0,,0,0,0,0,0,1,0,0,Matches,2022
361,Victor Lindelöf,se SWE,DF,Manchester Utd,27,1994,4.7,5,5,3,2,0,4,5,80.0,1,7,6,1,4,9,19,0,Matches,2022
362,Jesse Lingard,eng ENG,"MF,FW",Manchester Utd,28,1992,1.3,2,2,2,0,0,0,3,0.0,3,1,0,1,1,3,0,1,Matches,2022
363,Marcos Llorente,es ESP,"DF,MF",Atlético Madrid,26,1995,7.8,15,10,11,3,1,7,16,43.8,9,4,1,3,9,24,7,0,Matches,2022
364,Giovani Lo Celso,ar ARG,"MF,FW",Villarreal,25,1996,5.8,17,14,9,6,2,5,13,38.5,8,10,2,8,3,20,5,0,Matches,2022
365,Manuel Locatelli,it ITA,MF,Juventus,23,1998,5.9,13,7,8,4,1,2,9,22.2,7,11,6,5,9,22,3,0,Matches,2022
366,Renan Lodi,br BRA,"DF,FW",Atlético Madrid,23,1998,5.4,9,5,4,4,1,5,12,41.7,7,7,0,7,7,16,12,1,Matches,2022
367,Ruben Loftus-Cheek,eng ENG,"MF,DF",Chelsea,25,1996,4.0,9,6,2,5,2,4,7,57.1,3,3,0,3,1,10,0,0,Matches,2022
368,Matteo Lovato,it ITA,DF,Atalanta,21,2000,0.5,0,0,0,0,0,0,0,,0,0,0,0,1,1,1,0,Matches,2022
369,Dejan Lovren,hr CRO,DF,Zenit,32,1989,3.5,2,0,2,0,0,2,3,66.7,1,3,1,2,0,2,17,0,Matches,2022
370,José Luis Palomino,ar ARG,DF,Atalanta,31,1990,5.0,16,9,12,2,2,8,8,100.0,0,9,5,4,13,29,15,0,Matches,2022
371,Romelu Lukaku,be BEL,FW,Chelsea,28,1993,3.6,0,0,0,0,0,0,0,,0,0,0,0,0,0,1,0,Matches,2022
372,Dodi Lukebakio,be BEL,"FW,MF",Wolfsburg,23,1997,3.3,5,3,3,1,1,4,8,50.0,4,2,0,2,1,6,1,0,Matches,2022
373,Fabian Lustenberger,ch SUI,DF,Young Boys,33,1988,1.0,1,0,1,0,0,1,1,100.0,0,1,0,1,0,1,4,0,Matches,2022
374,Quentin Maceiras,ch SUI,"DF,MF",Young Boys,25,1995,1.3,2,1,0,1,1,1,3,33.3,2,1,0,1,1,3,3,0,Matches,2022
375,Harry Maguire,eng ENG,DF,Manchester Utd,28,1993,5.9,8,5,5,2,1,5,5,100.0,0,3,1,2,5,13,12,0,Matches,2022
376,Riyad Mahrez,dz ALG,FW,Manchester City,30,1991,10.9,19,12,8,8,3,7,26,26.9,19,17,1,16,8,27,2,0,Matches,2022
377,Nico Maier,ch SUI,FW,Young Boys,21,2000,0.0,0,0,0,0,0,0,0,,0,0,0,0,0,0,0,0,Matches,2022
378,Mike Maignan,fr FRA,GK,Milan,26,1995,3.0,0,0,0,0,0,0,0,,0,0,0,0,0,0,0,1,Matches,2022
379,Malcom,br BRA,"MF,FW",Zenit,24,1997,4.8,3,1,2,0,1,2,6,33.3,4,3,0,3,1,4,3,0,Matches,2022
380,Daniel Maldini,it ITA,"FW,MF",Milan,19,2001,0.3,1,1,1,0,0,0,1,0.0,1,1,0,1,0,1,0,0,Matches,2022
381,Donyell Malen,nl NED,FW,Dortmund,22,1999,4.3,1,1,1,0,0,0,4,0.0,4,1,0,1,3,4,0,0,Matches,2022
382,Ruslan Malinovskyi,ua UKR,"MF,FW",Atalanta,28,1993,3.3,9,6,1,5,3,5,9,55.6,4,4,0,4,1,10,2,0,Matches,2022
383,Felix Mambimbi,ch SUI,"FW,MF",Young Boys,20,2001,0.7,1,0,0,1,0,0,2,0.0,2,0,0,0,1,2,0,0,Matches,2022
384,Reinildo Mandava,mz MOZ,DF,Lille,27,1994,5.1,26,17,19,7,0,18,19,94.7,1,10,3,7,7,33,9,0,Matches,2022
385,Reinildo Mandava,mz MOZ,DF,Atlético Madrid,27,1994,4.0,8,6,5,3,0,6,8,75.0,2,5,4,1,3,11,7,0,Matches,2022
386,Aïssa Mandi,dz ALG,DF,Villarreal,29,1991,0.3,0,0,0,0,0,0,0,,0,0,0,0,0,0,0,0,Matches,2022
387,Sadio Mané,sn SEN,FW,Liverpool,29,1992,9.1,9,5,1,3,5,2,9,22.2,7,8,0,8,0,9,5,0,Matches,2022
388,Faitout Maouassa,fr FRA,MF,Club Brugge,23,1998,0.0,0,0,0,0,0,0,0,,0,0,0,0,0,0,0,0,Matches,2022
389,Iván Marcano,es ESP,DF,Porto,34,1987,1.4,1,1,1,0,0,1,3,33.3,2,3,3,0,1,2,11,0,Matches,2022
390,Marcelo,br BRA,DF,Real Madrid,33,1988,1.1,2,1,0,0,2,1,1,100.0,0,0,0,0,2,4,2,0,Matches,2022
391,José María Giménez,uy URU,DF,Atlético Madrid,26,1995,6.5,5,2,4,1,0,3,5,60.0,2,3,1,2,6,11,27,0,Matches,2022
392,Mariano,do DOM,FW,Real Madrid,27,1993,0.1,0,0,0,0,0,0,0,,0,0,0,0,0,0,0,0,Matches,2022
393,João Mário,pt POR,MF,Benfica,28,1993,5.4,6,2,1,5,0,3,6,50.0,3,2,0,2,6,12,1,0,Matches,2022
394,João Mário Lopes,pt POR,DF,Porto,21,2000,3.9,6,3,3,3,0,3,11,27.3,8,3,2,1,4,10,6,0,Matches,2022
395,Marlon,br BRA,DF,Shakhtar,25,1995,5.0,2,1,2,0,0,2,3,66.7,1,9,5,4,2,4,11,1,Matches,2022
396,Marlos,ua UKR,"FW,MF",Shakhtar,33,1988,2.3,2,1,1,1,0,2,5,40.0,3,1,0,1,0,2,1,0,Matches,2022
397,Marquinhos,br BRA,DF,Paris S-G,27,1994,8.0,10,7,7,3,0,3,4,75.0,1,16,9,7,4,14,41,1,Matches,2022
398,Anthony Martial,fr FRA,FW,Manchester Utd,25,1995,0.7,0,0,0,0,0,0,0,,0,0,0,0,0,0,1,0,Matches,2022
399,Josep Martinez,es ESP,GK,RB Leipzig,23,1998,1.0,0,0,0,0,0,0,0,,0,0,0,0,0,0,0,0,Matches,2022
400,Lautaro Martínez,ar ARG,FW,Inter,23,1997,6.4,3,3,1,2,0,3,4,75.0,1,7,1,6,6,9,1,0,Matches,2022
401,Lisandro Martínez,ar ARG,DF,Ajax,23,1998,8.0,13,10,5,6,2,4,11,36.4,7,7,1,6,12,25,24,1,Matches,2022
402,Toni Martínez,es ESP,FW,Porto,24,1997,1.6,2,1,0,1,1,2,2,100.0,0,0,0,0,0,2,1,0,Matches,2022
403,Christopher Martins,lu LUX,MF,Young Boys,24,1997,4.6,13,5,7,5,1,5,13,38.5,8,3,1,2,10,23,7,0,Matches,2022
404,Clinton Mata,ao ANG,DF,Club Brugge,28,1992,5.9,14,7,9,3,2,9,15,60.0,6,7,2,5,11,25,7,0,Matches,2022
405,Juan Mata,es ESP,MF,Manchester Utd,33,1988,1.1,3,1,1,2,0,2,2,100.0,0,1,0,1,0,3,0,0,Matches,2022
406,Nemanja Matić,rs SRB,"MF,DF",Manchester Utd,32,1988,2.2,3,2,1,2,0,1,3,33.3,2,0,0,0,4,7,4,2,Matches,2022
407,Joël Matip,cm CMR,DF,Liverpool,29,1991,7.0,8,6,3,3,2,4,5,80.0,1,2,1,1,6,14,16,0,Matches,2022
408,Mykola Matviyenko,ua UKR,DF,Shakhtar,25,1996,4.0,2,1,0,1,1,0,1,0.0,1,4,4,0,7,9,12,0,Matches,2022
409,Eric Maxim Choupo-Moting,cm CMR,FW,Bayern Munich,32,1989,0.6,0,0,0,0,0,0,1,0.0,1,0,0,0,0,0,0,0,Matches,2022
410,Maycon,br BRA,MF,Shakhtar,24,1997,5.3,9,3,5,3,1,2,8,25.0,6,4,2,2,9,18,3,0,Matches,2022
411,Noussair Mazraoui,ma MAR,DF,Ajax,23,1997,7.3,28,20,7,14,7,10,17,58.8,7,10,4,6,4,32,13,0,Matches,2022
412,Kevin Mbabu,ch SUI,DF,Wolfsburg,26,1995,3.6,7,3,5,1,1,3,5,60.0,2,3,0,3,5,12,11,1,Matches,2022
413,Noah Mbamba,be BEL,MF,Club Brugge,16,2005,0.6,4,1,0,3,1,0,0,,0,2,1,1,3,7,0,0,Matches,2022
414,Kylian Mbappé,fr FRA,FW,Paris S-G,22,1998,7.5,1,1,0,0,1,0,4,0.0,4,1,0,1,1,2,1,0,Matches,2022
415,Chancel Mbemba,cd COD,DF,Porto,26,1994,5.0,4,2,4,0,0,2,5,40.0,3,4,1,3,2,6,19,1,Matches,2022
416,Luke Mbete-Tatu,eng ENG,DF,Manchester City,17,2003,0.1,0,0,0,0,0,0,0,,0,0,0,0,0,0,0,0,Matches,2022
417,James Mcatee,eng ENG,MF,Manchester City,18,2002,0.5,1,1,0,0,1,1,1,100.0,0,1,0,1,0,1,0,0,Matches,2022
418,Weston McKennie,us USA,MF,Juventus,22,1998,4.3,8,6,4,3,1,2,6,33.3,4,8,0,8,7,15,5,1,Matches,2022
419,Scott McTominay,sct SCO,MF,Manchester Utd,24,1996,4.4,4,0,2,1,1,2,6,33.3,4,6,3,3,9,13,4,0,Matches,2022
420,Brandon Mechele,be BEL,DF,Club Brugge,28,1993,1.5,5,2,5,0,0,3,4,75.0,1,7,4,3,4,9,4,0,Matches,2022
421,Soualiho Meïté,fr FRA,MF,Benfica,27,1994,1.7,3,1,3,0,0,2,6,33.3,4,2,0,2,0,3,3,0,Matches,2022
422,Arthur Melo,br BRA,MF,Juventus,24,1996,3.0,4,4,1,3,0,1,5,20.0,4,7,1,6,4,8,2,0,Matches,2022
423,Memphis,nl NED,FW,Barcelona,27,1994,5.8,3,2,0,2,1,1,2,50.0,1,2,0,2,1,4,0,0,Matches,2022
424,Nuno Mendes,pt POR,DF,Paris S-G,19,2002,6.4,16,7,9,5,2,8,16,50.0,8,12,2,10,4,20,17,1,Matches,2022
425,Edouard Mendy,sn SEN,GK,Chelsea,29,1992,9.3,0,0,0,0,0,0,0,,0,0,0,0,0,0,1,1,Matches,2022
426,Ferland Mendy,fr FRA,DF,Real Madrid,26,1995,9.6,11,7,7,4,0,8,9,88.9,1,10,3,7,7,18,19,0,Matches,2022
427,Teden Mengi,eng ENG,DF,Manchester Utd,19,2002,0.3,0,0,0,0,0,0,0,,0,1,1,0,0,0,3,0,Matches,2022
428,Umut Meraş,tr TUR,DF,Beşiktaş,25,1995,2.8,3,2,3,0,0,2,4,50.0,2,5,1,4,7,10,14,0,Matches,2022
429,Lionel Messi,ar ARG,FW,Paris S-G,34,1987,7.0,3,0,3,0,0,0,8,0.0,8,4,0,4,0,3,0,0,Matches,2022
430,Junior Messias,br BRA,"FW,MF",Milan,30,1991,1.3,4,3,2,2,0,3,3,100.0,0,2,0,2,2,6,0,0,Matches,2022
431,Thomas Meunier,be BEL,DF,Dortmund,29,1991,5.4,13,8,9,2,2,5,12,41.7,7,5,1,4,11,24,10,0,Matches,2022
432,Simon Mignolet,be BEL,GK,Club Brugge,33,1988,6.0,0,0,0,0,0,0,0,,0,0,0,0,0,0,5,0,Matches,2022
433,Éder Militão,br BRA,DF,Real Madrid,23,1998,11.9,25,11,19,5,1,16,31,51.6,15,19,15,4,26,51,33,2,Matches,2022
434,James Milner,eng ENG,"MF,DF",Liverpool,35,1986,2.4,6,2,3,2,1,3,7,42.9,4,4,1,3,2,8,3,0,Matches,2022
435,Takumi Minamino,jp JPN,"FW,MF",Liverpool,26,1995,2.4,5,3,1,3,1,2,3,66.7,1,2,0,2,0,5,0,0,Matches,2022
436,Óscar Mingueza,es ESP,DF,Barcelona,22,1999,2.5,7,7,3,3,1,6,11,54.5,5,0,0,0,5,12,0,0,Matches,2022
437,Rafa Mir,es ESP,"FW,DF",Sevilla,24,1997,3.0,1,1,0,1,0,0,1,0.0,1,1,0,1,0,1,3,0,Matches,2022
438,Aleksei Miranchuk,ru RUS,FW,Atalanta,25,1995,0.4,1,0,1,0,0,0,0,,0,1,0,1,0,1,0,0,Matches,2022
439,Fabio Miretti,it ITA,MF,Juventus,17,2003,0.0,0,0,0,0,0,0,1,0.0,1,0,0,0,1,1,0,0,Matches,2022
440,Luka Modrić,hr CRO,MF,Real Madrid,35,1985,11.9,15,9,5,6,4,7,20,35.0,13,5,1,4,16,31,5,0,Matches,2022
441,Kudus Mohammed,gh GHA,MF,Ajax,20,2000,0.3,0,0,0,0,0,0,0,,0,0,0,0,0,0,0,0,Matches,2022
442,Niklas Moisander,fi FIN,DF,Malmö,35,1985,2.1,2,2,2,0,0,1,2,50.0,1,2,0,2,4,6,3,0,Matches,2022
443,Francisco Montero,es ESP,DF,Beşiktaş,22,1999,3.4,7,4,6,1,0,3,7,42.9,4,12,6,6,8,15,17,0,Matches,2022
444,Gonzalo Montiel,ar ARG,DF,Sevilla,24,1997,2.1,6,4,4,0,2,5,6,83.3,1,2,0,2,2,8,4,0,Matches,2022
445,Wesley Moraes,br BRA,FW,Club Brugge,24,1996,0.3,0,0,0,0,0,0,0,,0,0,0,0,0,0,0,0,Matches,2022
446,Álvaro Morata,es ESP,FW,Juventus,28,1992,5.7,6,4,2,1,3,2,5,40.0,3,3,1,2,0,6,7,0,Matches,2022
447,Morato,br BRA,DF,Benfica,20,2001,2.0,3,0,2,1,0,2,3,66.7,1,2,2,0,2,5,5,0,Matches,2022
448,Alberto Moreno,es ESP,"MF,DF",Villarreal,29,1992,3.5,2,1,2,0,0,2,5,40.0,3,1,0,1,5,7,3,0,Matches,2022
449,Gerard Moreno,es ESP,FW,Villarreal,29,1992,5.8,8,5,3,3,2,4,14,28.6,10,1,1,0,3,11,5,0,Matches,2022
450,Ilaix Moriba,gn GUI,MF,RB Leipzig,18,2003,0.7,1,1,0,1,0,1,5,20.0,4,1,0,1,1,2,0,0,Matches,2022
451,Tyler Morton,eng ENG,MF,Liverpool,18,2002,2.0,2,1,2,0,0,2,7,28.6,5,0,0,0,5,7,2,0,Matches,2022
452,Andrei Mostovoy,ru RUS,"MF,FW",Zenit,23,1997,1.7,1,1,0,1,0,0,2,0.0,2,3,0,3,2,3,0,1,Matches,2022
453,Youssoufa Moukoko,de GER,FW,Dortmund,16,2004,0.2,0,0,0,0,0,0,1,0.0,1,2,0,2,0,0,0,0,Matches,2022
454,Mason Mount,eng ENG,MF,Chelsea,22,1999,6.0,9,8,1,4,4,3,9,33.3,6,3,0,3,0,9,0,0,Matches,2022
455,Mykhailo Mudryk,ua UKR,"MF,FW",Shakhtar,20,2001,2.0,2,0,0,1,1,1,4,25.0,3,1,0,1,1,3,1,0,Matches,2022
456,Nordi Mukiele,fr FRA,DF,RB Leipzig,23,1997,5.4,15,5,10,4,1,7,14,50.0,7,5,2,3,8,23,10,0,Matches,2022
457,Thomas Müller,de GER,MF,Bayern Munich,31,1989,8.6,7,2,1,2,4,2,13,15.4,11,11,2,9,2,9,4,1,Matches,2022
458,Luis Muriel,co COL,"FW,MF",Atalanta,30,1991,1.5,2,1,0,2,0,1,3,33.3,2,0,0,0,1,3,0,0,Matches,2022
459,Jamal Musiala,de GER,"MF,FW",Bayern Munich,18,2003,5.0,10,6,0,7,3,3,14,21.4,11,8,0,8,8,18,2,0,Matches,2022
460,Juan Musso,ar ARG,GK,Atalanta,27,1994,6.0,1,0,1,0,0,1,1,100.0,0,0,0,0,0,1,2,1,Matches,2022
461,Vitaliy Mykolenko,ua UKR,DF,Dynamo Kyiv,22,1999,5.0,2,2,2,0,0,2,7,28.6,5,9,4,5,7,9,8,0,Matches,2022
462,Joakim Mæhle,dk DEN,DF,Atalanta,24,1997,4.8,11,7,6,3,2,6,9,66.7,3,4,1,3,6,17,6,0,Matches,2022
463,Georges-Kévin N'Koudou,cm CMR,FW,Beşiktaş,26,1995,1.0,1,1,0,1,0,0,0,,0,0,0,0,1,2,1,0,Matches,2022
464,Fabrice N'Sakala,cd COD,DF,Beşiktaş,31,1990,3.0,6,3,3,2,1,3,10,30.0,7,5,0,5,3,9,5,0,Matches,2022
465,Stanley N'Soki,fr FRA,DF,Club Brugge,22,1999,5.4,5,2,4,1,0,2,5,40.0,3,5,3,2,24,29,18,0,Matches,2022
466,Nacho,es ESP,DF,Real Madrid,31,1990,6.4,10,7,7,2,1,8,11,72.7,3,7,5,2,11,21,16,0,Matches,2022
467,Adi Nalic,ba BIH,"MF,FW",Malmö,23,1997,1.0,5,4,3,2,0,3,6,50.0,3,1,0,1,2,7,1,0,Matches,2022
468,Sebastian Nanasi,se SWE,"FW,MF",Malmö,19,2002,1.0,1,1,1,0,0,1,2,50.0,1,0,0,0,0,1,1,0,Matches,2022
469,Jesús Navas,es ESP,DF,Sevilla,35,1985,3.7,1,1,1,0,0,0,0,,0,3,1,2,4,5,4,0,Matches,2022
470,Keylor Navas,cr CRC,GK,Paris S-G,34,1986,3.0,0,0,0,0,0,0,0,,0,0,0,0,0,0,1,0,Matches,2022
471,Flávio Nazinho,pt POR,DF,Sporting CP,18,2003,0.2,0,0,0,0,0,0,0,,0,0,0,0,2,2,0,0,Matches,2022
472,David Neres,br BRA,FW,Ajax,24,1997,2.3,2,1,0,1,1,1,4,25.0,3,4,0,4,1,3,0,0,Matches,2022
473,Luís Neto,pt POR,DF,Sporting CP,33,1988,4.1,3,2,3,0,0,3,4,75.0,1,5,4,1,18,21,16,0,Matches,2022
474,Manuel Neuer,de GER,GK,Bayern Munich,35,1986,9.0,0,0,0,0,0,0,0,,0,0,0,0,0,0,2,1,Matches,2022
475,Neymar,br BRA,FW,Paris S-G,29,1992,5.2,6,3,4,2,0,2,7,28.6,5,2,0,2,0,6,0,1,Matches,2022
476,Moumi Ngamaleu,cm CMR,"FW,MF",Young Boys,27,1994,5.9,15,8,9,6,0,8,15,53.3,7,10,0,10,10,25,4,0,Matches,2022
477,Tanguy Nianzou,fr FRA,DF,Bayern Munich,19,2002,2.4,5,2,3,2,0,3,4,75.0,1,0,0,0,4,9,2,0,Matches,2022
478,Lasse Nielsen,dk DEN,DF,Malmö,33,1988,5.0,4,3,3,1,0,2,5,40.0,3,9,5,4,11,15,23,0,Matches,2022
479,Saúl Ñíguez,es ESP,"MF,DF",Chelsea,26,1994,1.8,8,4,3,5,0,3,4,75.0,1,7,3,4,2,10,8,0,Matches,2022
480,Boban Nikolov,mk MKD,MF,Sheriff Tiraspol,27,1994,1.1,3,2,2,1,0,0,0,,0,2,0,2,1,4,0,0,Matches,2022
481,Rasmus Nissen,dk DEN,DF,RB Salzburg,24,1997,8.0,37,24,22,12,3,25,39,64.1,14,9,2,7,10,47,20,0,Matches,2022
482,Christopher Nkunku,fr FRA,"FW,MF",RB Leipzig,23,1997,5.9,11,6,3,6,2,6,10,60.0,4,9,2,7,4,15,0,0,Matches,2022
483,Felix Nmecha,de GER,MF,Wolfsburg,20,2000,0.4,0,0,0,0,0,0,0,,0,0,0,0,0,0,0,0,Matches,2022
484,Lukas Nmecha,de GER,"FW,MF",Wolfsburg,22,1998,3.6,5,1,4,0,1,3,5,60.0,2,5,1,4,1,6,5,0,Matches,2022
485,Hugo Novoa,es ESP,FW,RB Leipzig,18,2003,0.3,0,0,0,0,0,0,1,0.0,1,0,0,0,0,0,0,0,Matches,2022
486,Matheus Nunes,pt POR,MF,Sporting CP,22,1998,5.6,12,9,5,7,0,5,13,38.5,8,6,1,5,7,19,9,0,Matches,2022
487,Darwin Núñez,uy URU,FW,Benfica,22,1999,6.8,6,0,1,2,3,3,7,42.9,4,7,0,7,0,6,10,0,Matches,2022
488,Jan Oblak,si SVN,GK,Atlético Madrid,28,1993,10.0,0,0,0,0,0,0,0,,0,0,0,0,0,0,3,0,Matches,2022
489,Lucas Ocampos,ar ARG,FW,Sevilla,27,1994,5.1,7,3,4,0,3,4,11,36.4,7,8,1,7,3,10,0,0,Matches,2022
490,Noah Okafor,ch SUI,FW,RB Salzburg,21,2000,3.8,3,2,1,1,1,0,1,0.0,1,3,0,3,1,4,0,0,Matches,2022
491,Sérgio Oliveira,pt POR,MF,Porto,29,1992,3.3,9,6,3,5,1,3,10,30.0,7,4,2,2,4,13,3,0,Matches,2022
492,Dani Olmo,es ESP,MF,RB Leipzig,23,1998,1.0,1,0,1,0,0,0,2,0.0,2,0,0,0,1,2,0,0,Matches,2022
493,Martin Olsson,se SWE,DF,Malmö,33,1988,3.2,1,1,1,0,0,1,3,33.3,2,3,0,3,3,4,10,0,Matches,2022
494,Amadou Onana,be BEL,"MF,DF",Lille,19,2001,2.9,9,6,6,2,1,4,5,80.0,1,2,0,2,0,9,3,0,Matches,2022
495,André Onana,cm CMR,GK,Ajax,25,1996,2.0,0,0,0,0,0,0,0,,0,0,0,0,0,0,1,1,Matches,2022
496,Jérôme Onguéné,cm CMR,DF,RB Salzburg,23,1997,4.8,6,4,4,1,1,2,6,33.3,4,5,2,3,14,20,17,0,Matches,2022
497,Willi Orban,hu HUN,DF,RB Leipzig,28,1992,3.5,11,6,3,6,2,9,10,90.0,1,5,4,1,6,17,8,0,Matches,2022
498,Divock Origi,be BEL,FW,Liverpool,26,1995,2.1,4,4,1,1,2,2,2,100.0,0,1,0,1,0,4,0,0,Matches,2022
499,Nicolás Otamendi,ar ARG,DF,Benfica,33,1988,9.0,13,10,10,3,0,8,14,57.1,6,16,7,9,19,32,56,0,Matches,2022
500,Otávio,pt POR,MF,Porto,26,1995,5.0,14,9,5,7,2,4,13,30.8,9,10,1,9,1,15,3,0,Matches,2022
501,Paulo Otávio,br BRA,"DF,MF",Wolfsburg,26,1994,1.9,5,3,3,2,0,2,10,20.0,8,6,1,5,4,9,3,0,Matches,2022
502,Alex Oxlade-Chamberlain,eng ENG,MF,Liverpool,27,1993,3.3,12,10,3,8,1,3,6,50.0,3,5,0,5,4,16,1,0,Matches,2022
503,Magomed Ozdoyev,ru RUS,MF,Zenit,28,1992,0.1,0,0,0,0,0,0,1,0.0,1,0,0,0,0,0,0,0,Matches,2022
504,Oğuzhan Özyakup,tr TUR,MF,Beşiktaş,28,1992,0.6,2,1,0,2,0,1,1,100.0,0,1,0,1,0,2,0,0,Matches,2022
505,João Palhinha,pt POR,MF,Sporting CP,26,1995,5.9,22,13,4,15,3,10,21,47.6,11,8,2,6,7,29,7,0,Matches,2022
506,Cole Palmer,eng ENG,"MF,FW",Manchester City,19,2002,0.5,2,0,1,0,1,0,2,0.0,2,0,0,0,0,2,0,0,Matches,2022
507,Leandro Paredes,ar ARG,MF,Paris S-G,27,1994,3.5,8,2,4,2,2,5,12,41.7,7,5,2,3,5,13,2,0,Matches,2022
508,Daniel Parejo,es ESP,MF,Villarreal,32,1989,11.7,20,9,9,7,4,8,16,50.0,8,10,1,9,9,29,5,1,Matches,2022
509,Mario Pašalić,hr CRO,MF,Atalanta,26,1995,2.4,2,1,0,2,0,1,4,25.0,3,1,0,1,2,4,3,0,Matches,2022
510,Felix Passlack,de GER,DF,Dortmund,23,1998,0.7,1,1,1,0,0,1,1,100.0,0,0,0,0,1,2,4,0,Matches,2022
511,Remko Pasveer,nl NED,GK,Ajax,37,1983,6.0,1,0,1,0,0,1,1,100.0,0,0,0,0,0,1,0,1,Matches,2022
512,Alan Patrick,br BRA,MF,Shakhtar,30,1991,3.0,3,1,1,1,1,2,4,50.0,2,2,0,2,2,5,1,0,Matches,2022
513,Paulinho,pt POR,"FW,MF",Sporting CP,28,1992,6.4,3,2,1,0,2,2,9,22.2,7,4,0,4,5,8,5,0,Matches,2022
514,Benjamin Pavard,fr FRA,DF,Bayern Munich,25,1996,8.5,14,8,8,4,2,7,14,50.0,7,11,4,7,18,32,20,1,Matches,2022
515,Alfonso Pedraza,es ESP,"DF,MF",Villarreal,25,1996,4.8,9,3,3,4,2,2,6,33.3,4,5,0,5,4,13,8,0,Matches,2022
516,Pedri,es ESP,MF,Barcelona,18,2002,1.7,4,3,2,2,0,3,5,60.0,2,2,0,2,1,5,1,0,Matches,2022
517,Pedrinho,br BRA,"MF,FW",Shakhtar,23,1998,3.8,3,2,0,2,1,1,1,100.0,0,2,0,2,0,3,0,0,Matches,2022
518,Jordan Pefok,us USA,FW,Young Boys,25,1996,3.8,3,3,0,3,0,2,4,50.0,2,2,1,1,1,4,2,0,Matches,2022
519,Luca Pellegrini,it ITA,DF,Juventus,22,1999,0.0,0,0,0,0,0,0,0,,0,0,0,0,0,0,1,0,Matches,2022
520,Carlos de Pena,uy URU,"FW,MF",Dynamo Kyiv,29,1992,4.1,6,4,3,1,2,4,11,36.4,7,3,0,3,11,17,3,0,Matches,2022
521,Rubén Peña,es ESP,DF,Villarreal,30,1991,0.2,2,1,1,1,0,2,2,100.0,0,1,0,1,0,2,1,0,Matches,2022
522,Sergio Peña,pe PER,MF,Malmö,25,1995,3.1,11,8,7,4,0,5,11,45.5,6,3,1,2,8,19,1,0,Matches,2022
523,Pepê,br BRA,"FW,MF",Porto,24,1997,0.4,0,0,0,0,0,0,0,,0,1,1,0,0,0,0,0,Matches,2022
524,Pepe,pt POR,DF,Porto,38,1983,3.9,4,3,2,2,0,2,4,50.0,2,6,3,3,6,10,14,0,Matches,2022
525,Danilo Pereira,pt POR,"MF,DF",Paris S-G,29,1991,4.0,3,2,2,1,0,2,2,100.0,0,3,2,1,4,7,15,1,Matches,2022
526,Mattia Perin,it ITA,GK,Juventus,28,1992,1.0,0,0,0,0,0,0,0,,0,0,0,0,0,0,0,0,Matches,2022
527,Ivan Perišić,hr CRO,DF,Inter,32,1989,5.9,13,6,7,3,3,6,10,60.0,4,5,2,3,7,20,11,0,Matches,2022
528,Pavao Pervan,at AUT,GK,Wolfsburg,33,1987,1.0,0,0,0,0,0,0,0,,0,0,0,0,0,0,1,0,Matches,2022
529,Matteo Pessina,it ITA,MF,Atalanta,24,1997,2.3,5,3,2,0,3,3,4,75.0,1,3,0,3,1,6,1,0,Matches,2022
530,Giuseppe Pezzella,it ITA,DF,Atalanta,23,1997,0.6,1,1,0,0,1,0,0,,0,0,0,0,0,1,3,0,Matches,2022
531,Maximilian Philipp,de GER,"MF,FW",Wolfsburg,27,1994,1.0,2,0,0,2,0,1,3,33.3,2,0,0,0,1,3,0,0,Matches,2022
532,Nathaniel Phillips,eng ENG,DF,Liverpool,24,1997,1.0,1,0,1,0,0,0,0,,0,1,1,0,1,2,4,0,Matches,2022
533,Kamil Piątkowski,pl POL,DF,RB Salzburg,21,2000,0.9,1,0,0,1,0,1,6,16.7,5,2,1,1,2,3,2,0,Matches,2022
534,Yeremi Pino,es ESP,"MF,DF",Villarreal,18,2002,4.7,8,2,5,1,2,4,9,44.4,5,9,1,8,8,16,5,0,Matches,2022
535,Gerard Piqué,es ESP,DF,Barcelona,34,1987,4.4,7,5,4,3,0,3,7,42.9,4,5,4,1,10,17,14,0,Matches,2022
536,Pizzi,pt POR,"MF,FW",Benfica,31,1989,1.8,1,0,1,0,0,0,4,0.0,4,0,0,0,0,1,0,0,Matches,2022
537,Miralem Pjanić,ba BIH,MF,Beşiktaş,31,1990,2.9,2,0,0,0,2,2,6,33.3,4,3,0,3,2,4,1,0,Matches,2022
538,Paul Pogba,fr FRA,"MF,FW",Manchester Utd,28,1993,3.8,7,3,1,5,1,2,5,40.0,3,3,1,2,1,8,2,1,Matches,2022
539,Marin Pongračić,hr CRO,DF,Dortmund,23,1997,1.9,0,0,0,0,0,0,0,,0,1,0,1,3,3,6,0,Matches,2022
540,Pedro Porro,es ESP,"DF,MF",Sporting CP,21,1999,5.8,12,5,9,3,0,7,20,35.0,13,7,0,7,11,23,6,0,Matches,2022
541,Yussuf Poulsen,dk DEN,FW,RB Leipzig,27,1994,1.7,0,0,0,0,0,0,2,0.0,2,0,0,0,1,1,4,0,Matches,2022
542,Riqui Puig,es ESP,MF,Barcelona,21,1999,0.2,1,1,1,0,0,0,1,0.0,1,0,0,0,0,1,0,0,Matches,2022
543,Christian Pulisic,us USA,"FW,MF",Chelsea,22,1998,4.1,3,3,1,1,1,2,5,40.0,3,4,0,4,1,4,0,0,Matches,2022
544,Andriy Pyatov,ua UKR,GK,Shakhtar,37,1984,2.9,0,0,0,0,0,0,0,,0,0,0,0,0,0,1,2,Matches,2022
545,Dani Raba,es ESP,FW,Villarreal,25,1995,0.1,0,0,0,0,0,0,0,,0,0,0,0,0,0,0,0,Matches,2022
546,Adrien Rabiot,fr FRA,MF,Juventus,26,1995,6.0,14,11,7,5,2,4,9,44.4,5,9,1,8,7,21,7,0,Matches,2022
547,Stjepan Radeljić,ba BIH,"DF,MF",Sheriff Tiraspol,23,1997,0.9,0,0,0,0,0,0,1,0.0,1,1,0,1,0,0,4,0,Matches,2022
548,Nemanja Radonjić,rs SRB,MF,Benfica,25,1996,0.4,0,0,0,0,0,0,0,,0,0,0,0,0,0,0,0,Matches,2022
549,Erdal Rakip,mk MKD,MF,Malmö,25,1996,3.0,6,2,2,2,2,3,6,50.0,3,3,1,2,0,6,0,0,Matches,2022
550,Ivan Rakitić,hr CRO,MF,Sevilla,33,1988,3.1,3,1,0,3,0,2,5,40.0,3,3,1,2,5,8,0,0,Matches,2022
551,Yaroslav Rakitskiy,ua UKR,DF,Zenit,31,1989,5.5,4,2,3,0,1,3,8,37.5,5,2,1,1,9,13,16,0,Matches,2022
552,Eric Ramírez,ve VEN,FW,Dynamo Kyiv,22,1998,0.2,0,0,0,0,0,0,0,,0,0,0,0,0,0,0,0,Matches,2022
553,Gonçalo Ramos,pt POR,"MF,FW",Benfica,20,2001,4.1,7,2,6,1,0,4,10,40.0,6,6,0,6,4,11,4,0,Matches,2022
554,Aaron Ramsey,wls WAL,"MF,FW",Juventus,30,1990,0.2,0,0,0,0,0,0,1,0.0,1,1,1,0,0,0,1,0,Matches,2022
555,Andrea Ranocchia,it ITA,DF,Inter,33,1988,1.1,1,0,0,1,0,1,2,50.0,1,2,0,2,1,2,1,0,Matches,2022
556,Marcus Rashford,eng ENG,"FW,MF",Manchester Utd,23,1997,2.8,6,6,2,3,1,2,2,100.0,0,5,0,5,0,6,0,0,Matches,2022
557,Ante Rebić,hr CRO,FW,Milan,27,1993,1.3,1,1,1,0,0,1,6,16.7,5,1,0,1,0,1,3,0,Matches,2022
558,Reinier,br BRA,"MF,FW",Dortmund,19,2002,1.4,3,1,0,3,0,1,1,100.0,0,2,0,2,0,3,2,0,Matches,2022
559,Matheus Reis,br BRA,DF,Sporting CP,26,1995,6.7,9,6,6,3,0,5,10,50.0,5,8,3,5,10,19,10,0,Matches,2022
560,Karim Rekik,nl NED,DF,Sevilla,26,1994,1.4,0,0,0,0,0,0,0,,0,4,1,3,1,1,2,0,Matches,2022
561,Devyne Rensch,nl NED,DF,Ajax,18,2003,0.8,2,2,2,0,0,2,3,66.7,1,1,1,0,1,3,0,0,Matches,2022
562,Marco Reus,de GER,"FW,MF",Dortmund,32,1989,5.5,12,6,2,7,3,8,13,61.5,5,9,0,9,2,14,5,0,Matches,2022
563,Federico Ricca,uy URU,DF,Club Brugge,26,1994,1.8,3,1,3,0,0,2,5,40.0,3,3,0,3,2,5,6,0,Matches,2022
564,Omar Richards,eng ENG,"DF,FW",Bayern Munich,23,1998,0.6,8,4,4,3,1,3,4,75.0,1,0,0,0,1,9,1,0,Matches,2022
565,Fabian Rieder,ch SUI,"MF,FW",Young Boys,19,2002,3.0,7,6,2,3,2,4,9,44.4,5,5,1,4,6,13,3,1,Matches,2022
566,Søren Rieks,dk DEN,"DF,MF",Malmö,34,1987,2.4,1,1,1,0,0,1,5,20.0,4,4,0,4,1,2,5,0,Matches,2022
567,Mats Rits,be BEL,MF,Club Brugge,28,1993,4.6,4,4,1,3,0,3,9,33.3,6,5,1,4,6,10,1,0,Matches,2022
568,Sergi Roberto,es ESP,"DF,FW",Barcelona,29,1992,1.9,0,0,0,0,0,0,1,0.0,1,2,1,1,1,1,2,0,Matches,2022
569,Andrew Robertson,sct SCO,DF,Liverpool,27,1994,9.2,9,5,3,4,2,3,13,23.1,10,13,3,10,12,21,14,0,Matches,2022
570,Marc Roca,es ESP,MF,Bayern Munich,24,1996,0.9,3,0,0,1,2,0,0,,0,2,0,2,1,4,0,0,Matches,2022
571,Rodri,es ESP,MF,Manchester City,25,1996,9.3,26,17,13,11,2,17,24,70.8,7,8,1,7,14,40,7,0,Matches,2022
572,Óscar Rodríguez Arnaiz,es ESP,FW,Sevilla,23,1998,0.3,0,0,0,0,0,0,0,,0,1,0,1,0,0,0,0,Matches,2022
573,Rodrygo,br BRA,"FW,MF",Real Madrid,20,2001,5.6,8,6,3,1,4,4,11,36.4,7,6,2,4,11,19,5,0,Matches,2022
574,Alessio Romagnoli,it ITA,DF,Milan,26,1995,4.4,8,5,5,2,1,4,5,80.0,1,7,4,3,9,17,20,0,Matches,2022
575,Iván Romero,es ESP,MF,Sevilla,20,2001,0.2,0,0,0,0,0,0,0,,0,0,0,0,0,0,0,0,Matches,2022
576,Cristiano Ronaldo,pt POR,FW,Manchester Utd,36,1985,6.8,3,1,1,1,1,2,3,66.7,1,6,0,6,0,3,7,0,Matches,2022
577,Marten de Roon,nl NED,"MF,DF",Atalanta,30,1991,5.4,16,9,6,5,5,8,14,57.1,6,5,0,5,15,31,9,1,Matches,2022
578,Valentin Rosier,fr FRA,DF,Beşiktaş,24,1996,4.5,12,6,7,3,2,7,13,53.8,6,7,0,7,9,21,10,0,Matches,2022
579,Jérôme Roussillon,fr FRA,DF,Wolfsburg,28,1993,4.0,8,3,5,2,1,4,7,57.1,3,7,1,6,3,11,12,1,Matches,2022
580,Antonio Rüdiger,de GER,DF,Chelsea,28,1993,9.3,13,9,9,3,1,7,11,63.6,4,7,2,5,6,19,13,1,Matches,2022
581,Daniele Rugani,it ITA,DF,Juventus,27,1994,2.0,6,3,1,5,0,1,1,100.0,0,4,2,2,1,7,3,0,Matches,2022
582,Gerónimo Rulli,ar ARG,GK,Villarreal,29,1992,12.0,0,0,0,0,0,0,1,0.0,1,1,0,1,0,0,8,3,Matches,2022
583,Serdar Saatçı,tr TUR,DF,Beşiktaş,18,2003,1.0,1,0,1,0,0,0,1,0.0,1,3,3,0,2,3,4,0,Matches,2022
584,Marcel Sabitzer,at AUT,MF,Bayern Munich,27,1994,1.5,1,0,1,0,0,0,4,0.0,4,2,2,0,2,3,1,0,Matches,2022
585,Alexis Saelemaekers,be BEL,FW,Milan,22,1999,4.9,13,5,6,5,2,5,16,31.3,11,9,1,8,5,18,3,1,Matches,2022
586,Mohamed Salah,eg EGY,FW,Liverpool,29,1992,11.2,7,3,1,2,4,2,8,25.0,6,4,0,4,2,9,0,0,Matches,2022
587,Renato Sanches,pt POR,"MF,FW",Lille,23,1997,4.5,5,4,2,2,1,4,10,40.0,6,3,1,2,3,8,4,1,Matches,2022
588,Alexis Sánchez,cl CHI,FW,Inter,32,1988,1.8,5,3,1,2,2,3,4,75.0,1,1,0,1,2,7,0,0,Matches,2022
589,Jadon Sancho,eng ENG,FW,Manchester Utd,21,2000,4.4,8,2,2,2,4,4,9,44.4,5,5,0,5,3,11,3,0,Matches,2022
590,Cisse Sandra,be BEL,FW,Club Brugge,17,2003,0.6,0,0,0,0,0,0,0,,0,1,0,1,0,0,0,0,Matches,2022
591,Alex Sandro,br BRA,DF,Juventus,30,1991,6.1,18,9,11,2,5,8,13,61.5,5,4,0,4,6,24,7,0,Matches,2022
592,Leroy Sané,de GER,"FW,MF",Bayern Munich,25,1996,8.8,14,8,5,7,2,1,8,12.5,7,6,0,6,4,18,0,0,Matches,2022
593,Douglas Santos,br BRA,"DF,MF",Zenit,27,1994,4.9,16,10,11,4,1,7,9,77.8,2,8,2,6,10,26,17,0,Matches,2022
594,Nuno Santos,pt POR,"MF,FW",Sporting CP,26,1995,2.4,0,0,0,0,0,0,6,0.0,6,1,0,1,1,1,0,0,Matches,2022
595,Zaidu Sanusi,ng NGA,DF,Porto,24,1997,4.3,14,9,11,2,1,8,12,66.7,4,7,0,7,4,18,9,1,Matches,2022
596,Pablo Sarabia,es ESP,"MF,FW",Sporting CP,29,1992,5.6,7,2,3,2,2,6,14,42.9,8,5,0,5,4,11,1,0,Matches,2022
597,Bouna Sarr,sn SEN,"DF,FW",Bayern Munich,29,1992,1.4,1,0,1,0,0,1,2,50.0,1,1,0,1,2,3,2,0,Matches,2022
598,Malang Sarr,fr FRA,DF,Chelsea,22,1999,1.1,4,2,2,1,1,2,5,40.0,3,3,2,1,1,5,7,0,Matches,2022
599,Charlie Savage,wls WAL,MF,Manchester Utd,18,2003,0.0,0,0,0,0,0,0,0,,0,0,0,0,1,1,0,0,Matches,2022
600,Stefan Savić,me MNE,DF,Atlético Madrid,30,1991,5.0,7,5,6,1,0,3,10,30.0,7,7,6,1,10,17,17,0,Matches,2022
601,Nico Schulz,de GER,DF,Dortmund,28,1993,2.2,7,4,2,4,1,5,6,83.3,1,3,1,2,2,9,1,1,Matches,2022
602,Perr Schuurs,nl NED,DF,Ajax,21,1999,1.6,3,2,1,2,0,2,2,100.0,0,1,0,1,3,6,3,0,Matches,2022
603,Haris Seferović,ch SUI,FW,Benfica,29,1992,0.1,0,0,0,0,0,0,0,,0,0,0,0,0,0,1,0,Matches,2022
604,Nicolas Seiwald,at AUT,MF,RB Salzburg,20,2001,7.2,26,13,7,12,7,15,35,42.9,20,23,3,20,4,30,9,0,Matches,2022
605,Stefano Sensi,it ITA,MF,Inter,25,1995,0.1,0,0,0,0,0,0,1,0.0,1,0,0,0,1,1,0,0,Matches,2022
606,Javier Serrano,es ESP,FW,Atlético Madrid,18,2003,0.2,0,0,0,0,0,0,0,,0,0,0,0,0,0,3,0,Matches,2022
607,Benjamin Šeško,si SVN,FW,RB Salzburg,18,2003,2.6,1,1,1,0,0,1,3,33.3,2,1,0,1,2,3,1,0,Matches,2022
608,Artem Shabanov,ua UKR,DF,Dynamo Kyiv,29,1992,1.0,1,0,1,0,0,0,0,,0,2,2,0,0,1,4,0,Matches,2022
609,Mykola Shaparenko,ua UKR,MF,Dynamo Kyiv,22,1998,5.4,17,9,7,10,0,4,19,21.1,15,6,0,6,9,26,3,1,Matches,2022
610,Luke Shaw,eng ENG,DF,Manchester Utd,26,1995,4.4,4,3,3,1,0,2,4,50.0,2,4,1,3,9,13,8,0,Matches,2022
611,Volodymyr Shepelyev,ua UKR,MF,Dynamo Kyiv,24,1997,0.6,0,0,0,0,0,0,2,0.0,2,0,0,0,1,1,0,0,Matches,2022
612,Oleksiy Shevchenko,ua UKR,GK,Shakhtar,29,1992,0.1,0,0,0,0,0,0,0,,0,0,0,0,0,0,0,0,Matches,2022
613,Ilya Shkurin,by BLR,FW,Dynamo Kyiv,21,1999,1.1,0,0,0,0,0,0,1,0.0,1,1,0,1,1,1,2,0,Matches,2022
614,Shola Shoretire,eng ENG,MF,Manchester Utd,17,2004,0.3,1,1,1,0,0,0,0,,0,1,0,1,0,1,0,0,Matches,2022
615,Vincent Sierro,ch SUI,MF,Young Boys,25,1995,2.7,3,2,2,0,1,2,3,66.7,1,3,0,3,2,5,4,0,Matches,2022
616,André Silva,pt POR,FW,RB Leipzig,25,1995,4.5,1,1,0,0,1,0,5,0.0,5,7,0,7,0,1,2,0,Matches,2022
617,Bernardo Silva,pt POR,"MF,FW",Manchester City,26,1994,9.7,16,8,8,2,6,9,26,34.6,17,11,0,11,7,23,5,0,Matches,2022
618,Bruno Felipe Souza da Silva,br BRA,"FW,MF",Sheriff Tiraspol,27,1994,3.5,6,4,4,2,0,2,7,28.6,5,7,1,6,1,7,4,0,Matches,2022
619,Cristiano da Silva Leite,br BRA,DF,Sheriff Tiraspol,27,1993,6.0,13,5,10,3,0,8,17,47.1,9,7,4,3,5,18,18,0,Matches,2022
620,Rafa Silva,pt POR,"FW,MF",Benfica,28,1993,7.8,11,4,6,5,0,6,19,31.6,13,3,0,3,5,16,1,0,Matches,2022
621,Thiago Silva,br BRA,DF,Chelsea,36,1984,8.4,7,5,4,3,0,4,5,80.0,1,8,6,2,12,19,14,0,Matches,2022
622,Mohamed Simakan,fr FRA,DF,RB Leipzig,21,2000,3.3,2,2,1,1,0,0,3,0.0,3,4,1,3,4,6,9,0,Matches,2022
623,Roko Simic,hr CRO,FW,RB Salzburg,17,2003,0.1,1,0,0,0,1,0,0,,0,0,0,0,0,1,0,0,Matches,2022
624,Milan Škriniar,sk SVK,DF,Inter,26,1995,8.0,15,9,6,6,3,7,11,63.6,4,16,12,4,9,24,22,0,Matches,2022
625,Islam Slimani,dz ALG,FW,Sporting CP,33,1988,1.2,0,0,0,0,0,0,0,,0,1,0,1,0,0,0,0,Matches,2022
626,Everton Soares,br BRA,"FW,MF",Benfica,25,1996,6.0,9,6,9,0,0,4,8,50.0,4,8,0,8,3,12,2,0,Matches,2022
627,Eduard Sobol,ua UKR,DF,Club Brugge,26,1995,3.7,8,4,4,3,1,3,9,33.3,6,3,0,3,6,14,6,0,Matches,2022
628,Oumar Solet,fr FRA,DF,RB Salzburg,21,2000,3.7,3,1,2,1,0,1,3,33.3,2,9,6,3,4,7,16,0,Matches,2022
629,Manor Solomon,il ISR,"MF,FW",Shakhtar,22,1999,3.6,4,3,1,3,0,1,4,25.0,3,5,0,5,1,5,2,0,Matches,2022
630,Josef de Souza,br BRA,MF,Beşiktaş,32,1989,4.9,19,11,13,6,0,8,20,40.0,12,9,1,8,15,34,7,0,Matches,2022
631,Kamal Sowah,gh GHA,"MF,DF",Club Brugge,21,2000,3.3,9,5,3,5,1,6,11,54.5,5,2,0,2,3,12,2,0,Matches,2022
632,Marvin Spielmann,ch SUI,MF,Young Boys,25,1996,0.1,0,0,0,0,0,0,0,,0,0,0,0,0,0,0,0,Matches,2022
633,Josip Stanišić,hr CRO,DF,Bayern Munich,21,2000,0.3,0,0,0,0,0,0,1,0.0,1,1,0,1,0,0,0,0,Matches,2022
634,Renato Steffen,ch SUI,FW,Wolfsburg,29,1991,2.9,11,5,6,4,1,7,12,58.3,5,3,0,3,1,12,2,0,Matches,2022
635,Zack Steffen,us USA,GK,Manchester City,26,1995,1.0,1,1,1,0,0,1,2,50.0,1,0,0,0,0,1,0,0,Matches,2022
636,Taras Stepanenko,ua UKR,MF,Shakhtar,31,1989,2.5,4,2,3,1,0,3,7,42.9,4,2,1,1,2,6,6,0,Matches,2022
637,Raheem Sterling,eng ENG,FW,Manchester City,26,1994,6.5,8,2,0,5,3,2,8,25.0,6,7,0,7,2,10,0,0,Matches,2022
638,John Stones,eng ENG,DF,Manchester City,27,1994,7.1,3,3,2,1,0,2,2,100.0,0,6,3,3,3,6,8,1,Matches,2022
639,Luis Suárez,uy URU,FW,Atlético Madrid,34,1987,3.8,1,1,0,0,1,1,1,100.0,0,0,0,0,1,2,2,0,Matches,2022
640,Luka Sučić,hr CRO,MF,RB Salzburg,18,2002,5.7,13,7,5,7,1,11,24,45.8,13,4,0,4,4,17,2,0,Matches,2022
641,Heorhii Sudakov,ua UKR,MF,Shakhtar,18,2002,0.6,1,1,0,1,0,0,1,0.0,1,0,0,0,0,1,0,0,Matches,2022
642,Niklas Süle,de GER,DF,Bayern Munich,25,1995,5.7,6,4,3,3,0,2,6,33.3,4,1,1,0,5,11,13,0,Matches,2022
643,Miralem Sulejmani,rs SRB,DF,Young Boys,32,1988,0.1,0,0,0,0,0,0,0,,0,0,0,0,0,0,0,0,Matches,2022
644,Vladyslav Supriaha,ua UKR,FW,Dynamo Kyiv,21,2000,0.9,1,0,0,1,0,0,0,,0,0,0,0,0,1,0,0,Matches,2022
645,Suso,es ESP,FW,Sevilla,27,1993,2.5,1,0,0,0,1,1,6,16.7,5,1,0,1,2,3,0,0,Matches,2022
646,Aleksei Sutormin,ru RUS,"DF,MF",Zenit,27,1994,3.3,1,0,1,0,0,1,3,33.3,2,0,0,0,2,3,4,0,Matches,2022
647,Serhiy Sydorchuk,ua UKR,MF,Dynamo Kyiv,30,1991,5.9,21,10,14,6,1,9,19,47.4,10,11,3,8,12,33,5,1,Matches,2022
648,Oleksandr Syrota,ua UKR,DF,Dynamo Kyiv,21,2000,5.0,8,5,5,3,0,5,13,38.5,8,6,3,3,6,14,31,0,Matches,2022
649,Wojciech Szczęsny,pl POL,GK,Juventus,31,1990,7.0,0,0,0,0,0,0,0,,0,1,0,1,0,0,2,1,Matches,2022
650,Dominik Szoboszlai,hu HUN,"FW,MF",RB Leipzig,20,2000,2.3,1,1,0,1,0,0,3,0.0,3,1,0,1,0,1,4,0,Matches,2022
651,Adel Taarabt,ma MAR,MF,Benfica,32,1989,3.8,3,2,3,0,0,3,10,30.0,7,3,0,3,3,6,1,0,Matches,2022
652,Bruno Tabata,br BRA,"MF,FW",Sporting CP,24,1997,2.3,2,1,2,0,0,0,4,0.0,4,2,0,2,0,2,1,0,Matches,2022
653,Dušan Tadić,rs SRB,FW,Ajax,32,1988,7.0,8,6,3,4,1,3,8,37.5,5,5,0,5,5,13,3,0,Matches,2022
654,Nicolás Tagliafico,ar ARG,DF,Ajax,28,1992,1.5,6,5,0,4,2,1,4,25.0,3,3,1,2,1,7,1,0,Matches,2022
655,Mehdi Taremi,ir IRN,FW,Porto,29,1992,5.4,6,4,1,3,2,3,16,18.8,13,7,0,7,3,9,8,0,Matches,2022
656,Ciprian Tătărușanu,ro ROU,GK,Milan,35,1986,3.0,0,0,0,0,0,0,0,,0,0,0,0,0,0,2,0,Matches,2022
657,Kenneth Taylor,nl NED,MF,Ajax,19,2002,0.5,2,1,0,1,1,0,0,,0,1,0,1,1,3,0,0,Matches,2022
658,Alex Teixeira,br BRA,MF,Beşiktaş,31,1990,2.0,4,4,2,2,0,3,3,100.0,0,3,0,3,2,6,0,0,Matches,2022
659,Alex Telles,br BRA,DF,Manchester Utd,28,1992,3.2,5,2,0,5,0,2,8,25.0,6,5,1,4,5,10,4,0,Matches,2022
660,Marc-André ter Stegen,de GER,GK,Barcelona,29,1992,6.0,0,0,0,0,0,0,0,,0,0,0,0,0,0,1,1,Matches,2022
661,Tetê,br BRA,"FW,MF",Shakhtar,21,2000,4.1,2,1,1,1,0,0,7,0.0,7,2,0,2,2,4,0,0,Matches,2022
662,Sébastien Thill,lu LUX,MF,Sheriff Tiraspol,27,1993,6.0,9,4,6,2,1,6,14,42.9,8,7,6,1,11,20,14,0,Matches,2022
663,Steffen Tigges,de GER,FW,Dortmund,23,1998,1.1,1,0,0,0,1,1,3,33.3,2,2,1,1,0,1,0,0,Matches,2022
664,Samson Tijani,ng NGA,MF,RB Salzburg,19,2002,0.3,0,0,0,0,0,0,2,0.0,2,0,0,0,1,1,1,0,Matches,2022
665,Malik Tillman,us USA,FW,Bayern Munich,19,2002,0.2,0,0,0,0,0,0,1,0.0,1,0,0,0,1,1,0,0,Matches,2022
666,Jurriën Timber,nl NED,DF,Ajax,20,2001,6.4,11,7,6,4,1,2,6,33.3,4,12,5,7,11,22,14,0,Matches,2022
667,Corentin Tolisso,fr FRA,MF,Bayern Munich,26,1994,2.6,2,0,1,1,0,1,7,14.3,6,3,1,2,4,6,3,0,Matches,2022
668,Rafael Tolói,it ITA,DF,Atalanta,30,1990,4.0,14,11,6,7,1,9,12,75.0,3,3,1,2,4,18,5,0,Matches,2022
669,Tiago Tomás,pt POR,"MF,FW",Sporting CP,19,2002,1.8,3,2,1,2,0,3,3,100.0,0,0,0,0,1,4,0,0,Matches,2022
670,Fikayo Tomori,eng ENG,DF,Milan,23,1997,4.6,5,2,3,2,0,2,5,40.0,3,14,11,3,5,10,21,2,Matches,2022
671,Sandro Tonali,it ITA,MF,Milan,21,2000,3.7,11,8,5,4,2,3,6,50.0,3,3,0,3,3,14,7,0,Matches,2022
672,Mehmet Topal,tr TUR,"MF,DF",Beşiktaş,35,1986,2.9,5,4,2,2,1,3,6,50.0,3,4,2,2,2,7,5,0,Matches,2022
673,Gökhan Töre,tr TUR,MF,Beşiktaş,29,1992,0.9,4,3,3,0,1,2,2,100.0,0,1,0,1,0,4,1,0,Matches,2022
674,Ferrán Torres,es ESP,FW,Manchester City,21,2000,0.8,0,0,0,0,0,0,1,0.0,1,1,0,1,1,1,0,0,Matches,2022
675,Óliver Torres,es ESP,MF,Sevilla,26,1994,1.9,3,1,2,1,0,2,8,25.0,6,5,0,5,0,3,1,0,Matches,2022
676,Pau Torres,es ESP,DF,Villarreal,24,1997,12.0,15,9,11,4,0,8,12,66.7,4,12,9,3,10,25,62,1,Matches,2022
677,Adama Traoré,ml MLI,"FW,MF",Sheriff Tiraspol,26,1995,5.9,8,6,3,4,1,2,11,18.2,9,6,2,4,6,14,7,0,Matches,2022
678,Manu Trigueros,es ESP,"MF,FW",Villarreal,29,1991,3.7,10,6,5,2,3,5,16,31.3,11,2,0,2,0,10,4,0,Matches,2022
679,Kieran Trippier,eng ENG,"DF,FW",Atlético Madrid,30,1990,2.4,8,1,3,5,0,6,6,100.0,0,6,1,5,0,8,1,0,Matches,2022
680,Anatolii Trubin,ua UKR,GK,Shakhtar,19,2001,3.0,0,0,0,0,0,0,0,,0,0,0,0,0,0,1,2,Matches,2022
681,Kostas Tsimikas,gr GRE,DF,Liverpool,25,1996,3.8,7,5,3,3,1,5,5,100.0,0,3,0,3,6,13,6,0,Matches,2022
682,Viktor Tsyhankov,ua UKR,"FW,MF",Dynamo Kyiv,23,1997,5.4,8,3,3,3,2,5,15,33.3,10,4,0,4,3,11,6,0,Matches,2022
683,Oleksandr Tymchyk,ua UKR,DF,Dynamo Kyiv,24,1997,1.8,2,2,1,1,0,1,3,33.3,2,1,0,1,0,2,2,0,Matches,2022
684,Salih Uçan,tr TUR,MF,Beşiktaş,27,1994,1.3,9,5,9,0,0,4,8,50.0,4,4,2,2,3,12,0,0,Matches,2022
685,Manuel Ugarte Ribeiro,uy URU,MF,Sporting CP,20,2001,2.3,7,2,4,3,0,1,10,10.0,9,1,0,1,4,11,0,0,Matches,2022
686,Andreas Ulmer,at AUT,DF,RB Salzburg,35,1985,7.9,19,10,12,7,0,11,28,39.3,17,4,0,4,12,31,9,0,Matches,2022
687,Sven Ulreich,de GER,GK,Bayern Munich,32,1988,1.0,0,0,0,0,0,0,0,,0,0,0,0,0,0,1,0,Matches,2022
688,Dayot Upamecano,fr FRA,DF,Bayern Munich,22,1998,7.3,15,13,9,6,0,11,21,52.4,10,9,2,7,14,29,11,0,Matches,2022
689,Mateus Uribe,co COL,MF,Porto,30,1991,3.2,11,7,4,7,0,4,12,33.3,8,4,0,4,9,20,2,0,Matches,2022
690,Necip Uysal,tr TUR,DF,Beşiktaş,30,1991,2.1,3,3,2,1,0,2,5,40.0,3,1,1,0,4,7,4,0,Matches,2022
691,Jesús Vallejo,es ESP,DF,Real Madrid,24,1997,0.1,0,0,0,0,0,0,0,,0,0,0,0,1,1,1,0,Matches,2022
692,Federico Valverde,uy URU,"MF,FW",Real Madrid,23,1998,8.9,20,12,9,8,3,7,19,36.8,12,17,2,15,9,29,13,0,Matches,2022
693,Ignace Van Der Brempt,be BEL,"MF,FW",Club Brugge,19,2002,1.8,11,7,5,4,2,4,6,66.7,2,2,0,2,1,12,1,0,Matches,2022
694,Virgil van Dijk,nl NED,DF,Liverpool,30,1991,9.0,5,2,3,2,0,4,4,100.0,0,3,1,2,13,18,29,0,Matches,2022
695,Hans Vanaken,be BEL,"MF,FW",Club Brugge,28,1992,6.0,6,4,3,1,2,2,13,15.4,11,4,0,4,8,14,4,0,Matches,2022
696,Raphaël Varane,fr FRA,DF,Manchester Utd,28,1993,3.9,3,1,0,3,0,1,2,50.0,1,6,4,2,5,8,16,1,Matches,2022
697,Berkay Vardar,az AZE,DF,Beşiktaş,18,2003,0.2,1,1,1,0,0,0,0,,0,1,0,1,1,2,0,0,Matches,2022
698,Lucas Vázquez,es ESP,"DF,FW",Real Madrid,30,1991,3.9,11,9,4,4,3,5,9,55.6,4,5,1,4,0,11,6,0,Matches,2022
699,Matías Vecino,uy URU,MF,Inter,29,1991,1.4,2,1,0,2,0,0,1,0.0,1,1,0,1,1,3,1,0,Matches,2022
700,Benjamin Verbič,si SVN,"MF,FW",Dynamo Kyiv,27,1993,1.0,1,0,1,0,0,1,2,50.0,1,0,0,0,0,1,0,1,Matches,2022
701,Lucas Veríssimo,br BRA,DF,Benfica,26,1995,3.0,5,2,5,0,0,1,3,33.3,2,6,3,3,8,13,15,0,Matches,2022
702,Marco Verratti,it ITA,MF,Paris S-G,28,1992,4.8,13,8,7,5,1,6,9,66.7,3,11,4,7,6,19,5,0,Matches,2022
703,Jan Vertonghen,be BEL,DF,Benfica,34,1987,10.0,15,7,7,8,0,4,6,66.7,2,11,7,4,12,27,42,1,Matches,2022
704,Domagoj Vida,hr CRO,DF,Beşiktaş,32,1989,2.0,3,1,3,0,0,1,1,100.0,0,4,4,0,4,7,4,0,Matches,2022
705,Arturo Vidal,cl CHI,MF,Inter,34,1987,4.6,20,13,9,7,4,5,12,41.7,7,5,1,4,4,24,6,0,Matches,2022
706,Fabio Vieira,pt POR,"MF,DF",Porto,21,2000,1.0,0,0,0,0,0,0,2,0.0,2,0,0,0,0,0,2,0,Matches,2022
707,Rúben Vinagre,pt POR,"MF,DF",Sporting CP,22,1999,0.7,0,0,0,0,0,0,1,0.0,1,1,1,0,0,0,2,1,Matches,2022
708,João Virgínia,pt POR,GK,Sporting CP,21,1999,1.0,0,0,0,0,0,0,0,,0,0,0,0,0,0,1,0,Matches,2022
709,Vitão,br BRA,DF,Shakhtar,21,2000,1.0,1,1,1,0,0,1,1,100.0,0,3,1,2,1,2,9,0,Matches,2022
710,Vitinha,pt POR,MF,Porto,21,2000,2.5,4,3,2,1,1,1,8,12.5,7,1,1,0,5,9,2,0,Matches,2022
711,Vitinho,br BRA,"FW,MF",Dynamo Kyiv,22,1999,1.1,0,0,0,0,0,0,2,0.0,2,3,0,3,0,0,0,0,Matches,2022
712,Odisseas Vlachodimos,gr GRE,GK,Benfica,27,1994,10.0,1,1,1,0,0,1,2,50.0,1,0,0,0,0,1,1,0,Matches,2022
713,Dušan Vlahović,rs SRB,FW,Juventus,21,2000,2.0,0,0,0,0,0,0,0,,0,0,0,0,0,0,0,0,Matches,2022
714,Ruud Vormer,nl NED,MF,Club Brugge,33,1988,1.8,3,2,3,0,0,3,5,60.0,2,2,1,1,1,4,0,0,Matches,2022
715,Aster Vranckx,be BEL,"MF,FW",Wolfsburg,18,2002,3.7,11,8,1,7,3,7,12,58.3,5,9,1,8,1,12,2,0,Matches,2022
716,Stefan de Vrij,nl NED,DF,Inter,29,1992,5.4,5,4,1,4,0,2,6,33.3,4,5,4,1,11,16,13,0,Matches,2022
717,Šime Vrsaljko,hr CRO,DF,Atlético Madrid,29,1992,3.4,11,8,5,6,0,8,12,66.7,4,4,3,1,8,19,13,0,Matches,2022
718,Luca Waldschmidt,de GER,"MF,FW",Wolfsburg,25,1996,1.3,1,1,0,0,1,0,0,,0,1,0,1,2,3,1,0,Matches,2022
719,Kyle Walker,eng ENG,DF,Manchester City,31,1990,6.4,13,7,8,5,0,10,12,83.3,2,6,4,2,9,22,7,0,Matches,2022
720,Aaron Wan-Bissaka,eng ENG,DF,Manchester Utd,23,1997,4.7,12,7,4,4,4,5,6,83.3,1,4,1,3,11,23,8,0,Matches,2022
721,Timothy Weah,us USA,"MF,FW",Lille,21,2000,2.8,5,4,3,2,0,4,5,80.0,1,4,0,4,1,6,1,0,Matches,2022
722,Wout Weghorst,nl NED,FW,Wolfsburg,28,1992,4.4,2,1,1,1,0,1,5,20.0,4,6,0,6,0,2,4,0,Matches,2022
723,Julian Weigl,de GER,MF,Benfica,25,1995,9.0,11,8,3,7,1,4,12,33.3,8,9,3,6,12,23,16,0,Matches,2022
724,Welinton,br BRA,DF,Beşiktaş,32,1989,3.5,14,9,8,6,0,9,14,64.3,5,9,3,6,6,20,11,0,Matches,2022
725,Wendel,br BRA,MF,Zenit,23,1997,5.3,12,6,7,5,0,4,10,40.0,6,6,0,6,6,18,6,0,Matches,2022
726,Wendell,br BRA,DF,Porto,28,1993,1.5,7,5,3,3,1,4,4,100.0,0,3,0,3,2,9,2,0,Matches,2022
727,Timo Werner,de GER,"FW,MF",Chelsea,25,1996,2.7,1,1,1,0,0,0,5,0.0,5,0,0,0,0,1,1,0,Matches,2022
728,Georginio Wijnaldum,nl NED,MF,Paris S-G,30,1990,2.9,0,0,0,0,0,0,2,0.0,2,3,0,3,1,1,5,0,Matches,2022
729,Neco Williams,wls WAL,"DF,FW",Liverpool,20,2001,2.0,6,5,4,1,1,4,6,66.7,2,7,1,6,1,7,2,0,Matches,2022
730,Axel Witsel,be BEL,MF,Dortmund,32,1989,5.2,8,4,4,3,1,4,11,36.4,7,5,3,2,7,15,5,0,Matches,2022
731,Maximilian Wöber,at AUT,DF,RB Salzburg,23,1998,6.3,13,7,7,6,0,6,10,60.0,4,10,6,4,14,27,30,0,Matches,2022
732,Marius Wolf,de GER,"DF,FW",Dortmund,26,1995,1.9,3,1,1,2,0,3,7,42.9,4,4,2,2,1,4,1,0,Matches,2022
733,Max Woltman,eng ENG,FW,Liverpool,17,2003,0.0,0,0,0,0,0,0,0,,0,0,0,0,0,0,0,0,Matches,2022
734,Xeka,pt POR,MF,Lille,26,1994,4.8,5,0,2,2,1,1,14,7.1,13,10,1,9,5,10,5,0,Matches,2022
735,Momo Yansané,gn GUI,FW,Sheriff Tiraspol,24,1997,1.7,1,1,1,0,0,0,1,0.0,1,0,0,0,0,1,1,0,Matches,2022
736,Roman Yaremchuk,ua UKR,FW,Benfica,25,1995,5.7,2,1,0,1,1,1,3,33.3,2,2,0,2,0,2,2,0,Matches,2022
737,Jasur Yaxshiboyev,uz UZB,FW,Sheriff Tiraspol,24,1997,2.2,1,1,0,0,1,1,3,33.3,2,2,1,1,0,1,1,0,Matches,2022
738,Yusuf Yazıcı,tr TUR,"MF,FW",Lille,24,1997,0.6,1,1,1,0,0,1,1,100.0,0,0,0,0,0,1,0,0,Matches,2022
739,Burak Yılmaz,tr TUR,FW,Lille,36,1985,5.9,0,0,0,0,0,0,1,0.0,1,4,2,2,0,0,2,0,Matches,2022
740,Rıdvan Yılmaz,tr TUR,"DF,MF",Beşiktaş,20,2001,1.5,4,3,4,0,0,1,1,100.0,0,4,1,3,4,8,3,0,Matches,2022
741,Illia Zabarnyi,ua UKR,DF,Dynamo Kyiv,18,2002,6.0,13,7,12,1,0,8,13,61.5,5,9,5,4,10,23,29,0,Matches,2022
742,Dan-Axel Zagadou,fr FRA,DF,Dortmund,22,1999,1.1,2,2,1,1,0,0,0,,0,0,0,0,1,3,1,0,Matches,2022
743,Denis Zakaria,ch SUI,MF,Juventus,24,1996,0.1,0,0,0,0,0,0,0,,0,0,0,0,0,0,0,0,Matches,2022
744,Duván Zapata,co COL,FW,Atalanta,30,1991,5.2,4,3,1,0,3,1,1,100.0,0,4,1,3,0,4,2,0,Matches,2022
745,Davide Zappacosta,it ITA,DF,Atalanta,29,1992,4.5,5,3,4,0,1,4,7,57.1,3,7,0,7,2,7,2,0,Matches,2022
746,Cedric Zesiger,ch SUI,DF,Young Boys,23,1998,0.0,0,0,0,0,0,0,0,,0,0,0,0,0,0,0,0,Matches,2022
747,Edon Zhegrova,xk KVX,FW,Lille,22,1999,0.1,0,0,0,0,0,0,0,,0,1,0,1,0,0,0,0,Matches,2022
748,Oleksandr Zinchenko,ua UKR,"DF,MF",Manchester City,24,1996,5.6,13,5,5,3,5,7,11,63.6,4,1,0,1,11,24,5,0,Matches,2022
749,Hakim Ziyech,ma MAR,"MF,FW",Chelsea,28,1993,4.9,7,4,1,3,3,0,3,0.0,3,6,1,5,4,11,1,0,Matches,2022
750,Blanco,,MF,Real Madrid,21,2000,0.1,,0,,,,,,,,,,,0,,,,Matches,2022
1,Pape Abou Cissé,sn SEN,DF,Olympiacos,24,1995,5.0,8,2,5,3,0,1,2,50.0,1,8,7,1,17,25,20,0,Matches,2021
2,Tammy Abraham,eng ENG,FW,Chelsea,22,1997,2.6,0,0,0,0,0,0,0,,0,2,1,1,1,1,2,0,Matches,2021
3,Francesco Acerbi,it ITA,DF,Lazio,32,1988,8.0,15,8,9,6,0,6,9,66.7,3,9,6,3,11,26,25,0,Matches,2021
4,Marcos Acuña,ar ARG,DF,Sevilla,28,1991,3.6,9,8,6,1,2,3,4,75.0,1,7,0,7,3,12,5,0,Matches,2021
5,Tyler Adams,us USA,"FW,MF",RB Leipzig,21,1999,3.2,7,5,3,4,0,4,8,50.0,4,3,0,3,5,12,3,0,Matches,2021
6,Karim Adeyemi,de GER,FW,RB Salzburg,18,2002,0.6,0,0,0,0,0,0,0,,0,1,0,1,0,0,0,0,Matches,2021
7,Adrián,es ESP,GK,Liverpool,33,1987,1.0,0,0,0,0,0,0,0,,0,0,0,0,0,0,1,1,Matches,2021
8,Nayef Aguerd,ma MAR,DF,Rennes,24,1996,3.1,1,1,1,0,0,0,0,,0,4,2,2,4,5,9,1,Matches,2021
9,Sergio Agüero,ar ARG,FW,Manchester City,32,1988,1.7,1,0,1,0,0,0,1,0.0,1,2,0,2,0,1,0,0,Matches,2021
10,Manuel Akanji,ch SUI,DF,Dortmund,25,1995,7.0,12,5,8,4,0,4,11,36.4,7,9,3,6,8,20,16,0,Matches,2021
11,Marley Aké,fr FRA,"FW,MF",Marseille,19,2001,0.4,0,0,0,0,0,0,0,,0,1,0,1,0,0,0,0,Matches,2021
12,Nathan Aké,nl NED,DF,Manchester City,25,1995,2.0,3,3,2,0,1,3,4,75.0,1,1,0,1,3,6,4,0,Matches,2021
13,Jean-Daniel Akpa-Akpro,ci CIV,MF,Lazio,27,1992,3.2,8,4,3,5,0,3,6,50.0,3,4,1,3,7,15,4,0,Matches,2021
14,David Alaba,at AUT,"DF,MF",Bayern Munich,28,1992,9.0,14,7,6,8,0,5,7,71.4,2,8,3,5,14,28,19,1,Matches,2021
15,Jordi Alba,es ESP,DF,Barcelona,31,1989,5.4,5,5,1,4,0,2,5,40.0,3,4,2,2,6,11,6,0,Matches,2021
16,Luis Alberto,es ESP,MF,Lazio,27,1992,5.3,17,5,9,3,5,6,21,28.6,15,5,2,3,4,21,2,0,Matches,2021
17,Thiago Alcántara,es ESP,MF,Liverpool,29,1991,2.5,10,8,5,3,2,1,2,50.0,1,4,1,3,3,13,5,1,Matches,2021
18,Danijel Aleksić,rs SRB,MF,Başakşehir,29,1991,1.2,0,0,0,0,0,0,3,0.0,3,2,0,2,0,0,1,0,Matches,2021
19,Carles Aleñá,es ESP,"MF,DF",Barcelona,22,1998,1.4,1,1,0,1,0,0,2,0.0,2,2,2,0,0,1,2,0,Matches,2021
20,Trent Alexander-Arnold,eng ENG,DF,Liverpool,21,1998,7.9,10,4,7,3,0,6,12,50.0,6,5,0,5,12,22,9,2,Matches,2021
21,Hasan Ali Kaldırım,tr TUR,DF,Başakşehir,30,1989,1.2,1,0,0,1,0,1,1,100.0,0,5,2,3,1,2,2,0,Matches,2021
22,Alisson,br BRA,GK,Liverpool,27,1992,7.0,1,0,1,0,0,1,1,100.0,0,0,0,0,0,1,4,0,Matches,2021
23,Marcos Alonso,es ESP,DF,Chelsea,29,1990,2.0,1,1,1,0,0,1,1,100.0,0,3,0,3,0,1,4,0,Matches,2021
24,Éder Álvarez Balanta,co COL,MF,Club Brugge,27,1993,2.6,2,0,2,0,0,1,7,14.3,6,3,2,1,4,6,5,0,Matches,2021
25,Edson Álvarez,mx MEX,"MF,DF",Ajax,22,1997,1.4,3,0,1,1,1,0,1,0.0,1,3,2,1,3,6,5,0,Matches,2021
26,Jordan Amavi,fr FRA,DF,Marseille,26,1994,5.0,8,7,5,3,0,4,8,50.0,4,2,1,1,10,18,6,0,Matches,2021
27,Mikkel Andersen,dk DEN,GK,Midtjylland,31,1988,2.0,0,0,0,0,0,0,0,,0,0,0,0,0,0,0,0,Matches,2021
28,Felipe Anderson,br BRA,FW,Porto,27,1993,0.7,1,1,0,1,0,0,2,0.0,2,1,0,1,4,5,0,0,Matches,2021
29,Mikael Anderson,is ISL,"MF,FW",Midtjylland,22,1998,1.9,6,3,3,3,0,0,2,0.0,2,1,0,1,2,8,3,0,Matches,2021
30,Joel Andersson,se SWE,DF,Midtjylland,23,1996,4.4,7,6,4,3,0,3,6,50.0,3,4,0,4,9,16,6,0,Matches,2021
31,Oleksandr Andriyevskyi,ua UKR,MF,Dynamo Kyiv,26,1994,1.4,3,1,2,1,0,0,2,0.0,2,1,0,1,2,5,3,0,Matches,2021
32,Angeliño,es ESP,"DF,FW",RB Leipzig,23,1997,7.0,15,7,7,7,1,7,10,70.0,3,8,0,8,2,17,6,0,Matches,2021
33,Faustino Anjorin,eng ENG,FW,Chelsea,18,2001,0.9,4,3,0,2,2,1,1,100.0,0,1,0,1,0,4,0,0,Matches,2021
34,Marcos Antônio,br BRA,MF,Shakhtar,20,2000,2.7,2,1,1,1,0,2,3,66.7,1,5,1,4,2,4,1,0,Matches,2021
35,Antony,br BRA,FW,Ajax,20,2000,4.0,7,3,4,3,0,0,9,0.0,9,7,1,6,3,10,2,0,Matches,2021
36,Youssef El-Arabi,ma MAR,FW,Olympiacos,33,1987,4.7,1,0,0,1,0,1,3,33.3,2,1,1,0,1,2,4,0,Matches,2021
37,Ronald Araújo,uy URU,DF,Barcelona,21,1999,1.6,6,3,4,2,0,3,4,75.0,1,2,0,2,2,8,2,0,Matches,2021
38,Ari,ru RUS,FW,Krasnodar,34,1985,0.3,0,0,0,0,0,0,0,,0,0,0,0,0,0,0,0,Matches,2021
39,Bright Arrey-Mbi,de GER,DF,Bayern Munich,17,2003,0.7,0,0,0,0,0,0,0,,0,0,0,0,0,0,1,0,Matches,2021
40,Sergio Arribas,es ESP,FW,Real Madrid,18,2001,0.4,0,0,0,0,0,0,1,0.0,1,0,0,0,0,0,0,0,Matches,2021
41,Kepa Arrizabalaga,es ESP,GK,Chelsea,25,1994,1.0,0,0,0,0,0,0,0,,0,0,0,0,0,0,0,0,Matches,2021
42,Marco Asensio,es ESP,FW,Real Madrid,24,1996,6.9,6,6,2,1,3,3,7,42.9,4,5,0,5,4,10,0,0,Matches,2021
43,Majeed Ashimeru,gh GHA,MF,RB Salzburg,22,1997,0.5,2,2,0,1,1,2,3,66.7,1,1,0,1,1,3,0,0,Matches,2021
44,Sardar Azmoun,ir IRN,FW,Zenit,25,1995,3.2,0,0,0,0,0,0,2,0.0,2,1,0,1,1,1,3,0,Matches,2021
45,César Azpilicueta,es ESP,DF,Chelsea,30,1989,10.7,26,14,14,11,1,16,23,69.6,7,21,9,12,11,37,31,0,Matches,2021
46,Demba Ba,sn SEN,FW,Başakşehir,35,1985,3.6,1,0,0,1,0,0,4,0.0,4,1,1,0,2,3,2,0,Matches,2021
47,Ousseynou Ba,sn SEN,DF,Olympiacos,24,1995,2.1,5,3,5,0,0,1,5,20.0,4,2,1,1,1,6,12,0,Matches,2021
48,Youssouph Badji,sn SEN,FW,Club Brugge,18,2001,0.4,0,0,0,0,0,0,1,0.0,1,1,1,0,0,0,0,0,Matches,2021
49,Mitchel Bakker,nl NED,DF,Paris S-G,20,2000,4.6,7,6,3,3,1,3,7,42.9,4,2,0,2,4,11,13,1,Matches,2021
50,Leonardo Balerdi,ar ARG,DF,Marseille,21,1999,2.8,2,0,1,1,0,1,3,33.3,2,2,1,1,7,9,2,0,Matches,2021
51,Tudor Băluță,ro ROU,MF,Dynamo Kyiv,21,1999,0.1,0,0,0,0,0,0,0,,0,1,1,0,1,1,0,0,Matches,2021
52,Nicolò Barella,it ITA,MF,Inter,23,1997,5.9,14,11,2,9,3,4,15,26.7,11,4,0,4,6,20,0,0,Matches,2021
53,Romário Baró,pt POR,MF,Porto,20,2000,0.7,1,0,0,1,0,1,3,33.3,2,0,0,0,1,2,2,0,Matches,2021
54,Wílmar Barrios,co COL,MF,Zenit,26,1993,5.5,12,9,10,2,0,6,14,42.9,8,9,4,5,15,27,10,0,Matches,2021
55,Alessandro Bastoni,it ITA,DF,Inter,21,1999,4.6,5,2,3,2,0,3,7,42.9,4,1,0,1,4,9,8,0,Matches,2021
56,Roko Baturina,hr CRO,FW,Ferencváros,20,2000,0.4,0,0,0,0,0,0,0,,0,0,0,0,0,0,0,0,Matches,2021
57,Donny van de Beek,nl NED,"MF,FW",Manchester Utd,23,1997,3.1,5,2,1,0,4,2,3,66.7,1,2,0,2,2,7,1,0,Matches,2021
58,Jude Bellingham,eng ENG,MF,Dortmund,17,2003,7.6,24,9,7,9,8,8,16,50.0,8,19,2,17,5,29,8,0,Matches,2021
59,Darío Benedetto,ar ARG,FW,Marseille,30,1990,2.9,1,1,1,0,0,0,0,,0,3,0,3,0,1,2,0,Matches,2021
60,László Bénes,sk SVK,MF,M'Gladbach,22,1997,0.2,0,0,0,0,0,0,1,0.0,1,0,0,0,0,0,0,0,Matches,2021
61,Ramy Bensebaini,dz ALG,DF,M'Gladbach,25,1995,5.0,15,9,10,5,0,10,16,62.5,6,10,0,10,11,26,19,2,Matches,2021
62,Rodrigo Bentancur,uy URU,MF,Juventus,23,1997,5.2,13,12,5,8,0,6,10,60.0,4,8,1,7,10,23,9,1,Matches,2021
63,Karim Benzema,fr FRA,FW,Real Madrid,32,1987,9.3,8,2,1,5,2,2,3,66.7,1,3,1,2,2,10,2,0,Matches,2021
64,Marcus Berg,se SWE,FW,Krasnodar,33,1986,5.7,3,1,0,2,1,2,7,28.6,5,5,0,5,2,5,4,0,Matches,2021
65,Mergim Berisha,de GER,"MF,FW",RB Salzburg,22,1998,5.2,1,1,1,0,0,0,8,0.0,8,2,0,2,3,4,2,0,Matches,2021
66,Federico Bernardeschi,it ITA,"MF,FW",Juventus,26,1994,1.7,2,1,1,0,1,0,0,,0,1,0,1,2,4,3,0,Matches,2021
67,Miha Blažič,si SVN,DF,Ferencváros,27,1993,6.0,5,3,3,2,0,2,7,28.6,5,5,3,2,16,21,21,0,Matches,2021
68,Daley Blind,nl NED,"DF,MF",Ajax,30,1990,4.6,9,5,1,8,0,2,6,33.3,4,5,2,3,5,14,14,2,Matches,2021
69,Jérôme Boateng,de GER,DF,Bayern Munich,31,1988,5.8,15,6,9,5,1,9,13,69.2,4,9,5,4,14,29,17,0,Matches,2021
70,Franck Boli,ci CIV,FW,Ferencváros,26,1993,0.9,1,1,0,0,1,0,0,,0,0,0,0,0,1,0,0,Matches,2021
71,Boli Bolingoli-Mbombo,be BEL,DF,Başakşehir,25,1995,4.1,4,1,3,0,1,3,6,50.0,3,11,4,7,9,13,9,0,Matches,2021
72,Valerii Bondar,ua UKR,DF,Shakhtar,21,1999,6.0,6,4,5,1,0,4,7,57.1,3,13,6,7,10,16,33,0,Matches,2021
73,Leonardo Bonucci,it ITA,DF,Juventus,33,1987,5.5,5,1,2,3,0,3,5,60.0,2,2,2,0,8,13,9,0,Matches,2021
74,Endre Botka,hu HUN,DF,Ferencváros,25,1994,2.9,1,0,0,0,1,0,3,0.0,3,5,3,2,5,6,5,0,Matches,2021
75,Andreas Bouchalakis,gr GRE,MF,Olympiacos,27,1993,4.6,7,1,0,6,1,3,8,37.5,5,5,1,4,9,16,3,2,Matches,2021
76,Yassine Bounou,ma MAR,GK,Sevilla,29,1991,5.0,0,0,0,0,0,0,0,,0,0,0,0,0,0,0,0,Matches,2021
77,Benjamin Bourigeaud,fr FRA,MF,Rennes,26,1994,4.1,4,2,2,1,1,2,13,15.4,11,7,1,6,5,9,6,0,Matches,2021
78,Denys Boyko,ua UKR,GK,Dynamo Kyiv,32,1988,1.0,0,0,0,0,0,0,0,,0,0,0,0,0,0,0,0,Matches,2021
79,Martin Braithwaite,dk DEN,FW,Barcelona,29,1991,2.6,1,0,0,0,1,0,1,0.0,1,2,0,2,0,1,1,0,Matches,2021
80,Julian Brandt,de GER,MF,Dortmund,24,1996,2.4,4,2,2,2,0,2,4,50.0,2,0,0,0,0,4,4,0,Matches,2021
81,Brian Brobbey,nl NED,FW,Ajax,18,2002,0.5,1,1,0,0,1,0,0,,0,0,0,0,0,1,0,0,Matches,2021
82,Marcelo Brozović,hr CRO,MF,Inter,27,1992,4.1,6,3,1,3,2,1,7,14.3,6,12,3,9,4,10,0,0,Matches,2021
83,Bruma,pt POR,"FW,MF",Olympiacos,25,1994,0.7,0,0,0,0,0,0,1,0.0,1,1,0,1,0,0,0,0,Matches,2021
84,Gianluigi Buffon,it ITA,GK,Juventus,42,1978,1.0,0,0,0,0,0,0,0,,0,0,0,0,0,0,0,0,Matches,2021
85,Roman Bürki,ch SUI,GK,Dortmund,29,1990,4.0,0,0,0,0,0,0,0,,0,0,0,0,1,1,0,0,Matches,2021
86,Heorhiy Bushchan,ua UKR,GK,Dynamo Kyiv,26,1994,4.0,0,0,0,0,0,0,0,,0,0,0,0,1,1,6,2,Matches,2021
87,Sergio Busquets,es ESP,MF,Barcelona,32,1988,3.7,8,3,2,3,3,5,12,41.7,7,3,0,3,1,9,1,0,Matches,2021
88,Vitaliy Buyalskyi,ua UKR,"FW,MF",Dynamo Kyiv,27,1993,3.8,9,6,5,4,0,4,11,36.4,7,4,0,4,4,13,0,0,Matches,2021
89,Rémy Cabella,fr FRA,"MF,FW",Krasnodar,30,1990,2.8,6,4,1,4,1,0,5,0.0,5,3,1,2,0,6,0,0,Matches,2021
90,Júnior Caiçara,br BRA,DF,Başakşehir,31,1989,0.3,0,0,0,0,0,0,0,,0,1,1,0,0,0,3,0,Matches,2021
91,Felipe Caicedo,ec ECU,FW,Lazio,31,1988,1.5,0,0,0,0,0,0,0,,0,0,0,0,0,0,0,0,Matches,2021
92,Jens Cajuste,se SWE,MF,Midtjylland,20,1999,3.6,7,5,3,3,1,3,9,33.3,6,8,2,6,5,12,3,1,Matches,2021
93,Mattia Caldara,it ITA,MF,Atalanta,26,1994,0.1,0,0,0,0,0,0,0,,0,0,0,0,0,0,0,0,Matches,2021
94,Duje Ćaleta-Car,hr CRO,DF,Marseille,23,1996,4.0,3,1,3,0,0,1,3,33.3,2,3,3,0,5,8,14,0,Matches,2021
95,Mohamed Camara,gn GUI,MF,Olympiacos,23,1997,3.2,9,3,4,5,0,3,9,33.3,6,0,0,0,0,9,0,0,Matches,2021
96,Mohamed Camara,ml MLI,MF,RB Salzburg,20,2000,4.6,15,8,4,9,2,7,19,36.8,12,10,0,10,11,26,2,0,Matches,2021
97,Eduardo Camavinga,fr FRA,MF,Rennes,17,2002,3.6,6,3,0,3,3,2,9,22.2,7,4,2,2,6,12,1,0,Matches,2021
98,Sergio Camello,es ESP,FW,Atlético Madrid,19,2001,0.1,0,0,0,0,0,0,0,,0,0,0,0,0,0,0,0,Matches,2021
99,Emre Can,de GER,"MF,DF",Dortmund,26,1994,5.2,7,5,5,2,0,3,8,37.5,5,11,7,4,5,12,13,1,Matches,2021
100,João Cancelo,pt POR,DF,Manchester City,26,1994,6.7,24,17,9,10,5,11,20,55.0,9,2,0,2,6,30,8,1,Matches,2021
101,Diego Carlos,br BRA,DF,Sevilla,27,1993,8.0,9,6,4,4,1,3,5,60.0,2,9,4,5,12,21,25,1,Matches,2021
102,Yannick Carrasco,be BEL,"MF,DF",Atlético Madrid,26,1993,4.2,4,2,2,0,2,4,5,80.0,1,4,0,4,1,5,3,0,Matches,2021
103,Dani Carvajal,es ESP,DF,Real Madrid,28,1992,1.8,3,1,0,0,3,2,2,100.0,0,3,0,3,2,5,1,0,Matches,2021
104,Casemiro,br BRA,MF,Real Madrid,28,1992,9.2,23,13,11,12,0,8,25,32.0,17,18,3,15,18,41,12,0,Matches,2021
105,Danilo Cataldi,it ITA,MF,Lazio,25,1994,1.0,1,0,1,0,0,0,3,0.0,3,1,0,1,1,2,1,0,Matches,2021
106,Edinson Cavani,uy URU,FW,Manchester Utd,33,1987,2.3,1,0,0,1,0,1,3,33.3,2,2,0,2,0,1,0,0,Matches,2021
107,Murilo Cerqueira,br BRA,DF,Loko Moscow,23,1997,5.0,6,5,3,3,0,3,6,50.0,3,8,2,6,11,17,43,1,Matches,2021
108,Nacer Chadli,be BEL,MF,Başakşehir,30,1989,1.3,0,0,0,0,0,0,1,0.0,1,5,0,5,0,0,0,0,Matches,2021
109,Yevgeni Chernov,ru RUS,DF,Krasnodar,27,1992,3.2,1,0,0,1,0,1,2,50.0,1,3,3,0,3,4,10,0,Matches,2021
110,Giorgio Chiellini,it ITA,DF,Juventus,35,1984,1.6,1,1,1,0,0,1,2,50.0,1,0,0,0,2,3,5,1,Matches,2021
111,Federico Chiesa,it ITA,"MF,FW",Juventus,22,1997,6.1,9,5,3,3,3,3,12,25.0,9,5,0,5,1,10,4,0,Matches,2021
112,Ben Chilwell,eng ENG,"DF,FW",Chelsea,23,1996,8.6,11,6,7,2,2,8,19,42.1,11,7,0,7,15,26,31,1,Matches,2021
113,Andreas Christensen,dk DEN,DF,Chelsea,24,1996,6.6,3,2,0,3,0,2,5,40.0,3,4,4,0,10,13,21,0,Matches,2021
114,Eldar Ćivić,ba BIH,DF,Ferencváros,24,1996,0.7,4,2,3,1,0,3,7,42.9,4,2,0,2,2,6,1,0,Matches,2021
115,Viktor Claesson,se SWE,"FW,MF",Krasnodar,28,1992,3.2,2,1,0,2,0,1,7,14.3,6,6,0,6,6,8,2,0,Matches,2021
116,Leighton Clarkson,eng ENG,MF,Liverpool,18,2001,1.0,0,0,0,0,0,0,3,0.0,3,0,0,0,0,0,4,0,Matches,2021
117,Kingsley Coman,fr FRA,FW,Bayern Munich,24,1996,6.0,7,2,3,1,3,3,7,42.9,4,6,0,6,2,9,3,0,Matches,2021
118,Francisco Conceição,pt POR,"FW,MF",Porto,17,2002,0.1,1,0,0,1,0,1,1,100.0,0,0,0,0,0,1,0,0,Matches,2021
119,Dion Cools,my MAS,DF,Midtjylland,24,1996,2.3,4,2,2,2,0,0,2,0.0,2,1,0,1,6,10,6,0,Matches,2021
120,Vedran Ćorluka,hr CRO,DF,Loko Moscow,34,1986,4.5,10,7,9,1,0,7,10,70.0,3,7,7,0,11,21,25,0,Matches,2021
121,Jesús Corona,mx MEX,"MF,FW",Porto,27,1993,8.4,10,2,9,1,0,6,17,35.3,11,11,0,11,13,23,9,1,Matches,2021
122,Ángel Correa,ar ARG,"MF,FW",Atlético Madrid,25,1995,5.4,3,1,1,2,0,2,12,16.7,10,5,0,5,0,3,8,0,Matches,2021
123,Joaquín Correa,ar ARG,FW,Lazio,25,1994,7.4,4,4,2,2,0,1,9,11.1,8,3,1,2,1,5,4,0,Matches,2021
124,Diogo Costa,pt POR,GK,Porto,20,1999,1.0,0,0,0,0,0,0,0,,0,0,0,0,0,0,0,0,Matches,2021
125,Douglas Costa,br BRA,"FW,MF",Bayern Munich,29,1990,2.6,1,1,0,0,1,1,1,100.0,0,1,0,1,1,2,0,0,Matches,2021
126,Thibaut Courtois,be BEL,GK,Real Madrid,28,1992,12.0,0,0,0,0,0,0,1,0.0,1,0,0,0,0,0,4,0,Matches,2021
127,Philippe Coutinho,br BRA,"FW,MF",Barcelona,28,1992,1.5,0,0,0,0,0,0,1,0.0,1,2,1,1,1,1,0,0,Matches,2021
128,Enzo Crivelli,fr FRA,FW,Başakşehir,25,1995,2.7,0,0,0,0,0,0,3,0.0,3,2,0,2,0,0,0,0,Matches,2021
129,Juan Cuadrado,co COL,DF,Juventus,32,1988,6.1,12,8,6,6,0,8,18,44.4,10,4,1,3,5,17,4,0,Matches,2021
130,Mickaël Cuisance,fr FRA,"MF,FW",Marseille,20,1999,2.6,8,5,4,2,2,2,9,22.2,7,2,0,2,2,10,0,0,Matches,2021
131,Szymon Czyż,pl POL,MF,Lazio,19,2001,0.3,3,3,1,0,2,1,2,50.0,1,0,0,0,0,3,0,0,Matches,2021
132,Danilo D'Ambrosio,it ITA,DF,Inter,31,1988,3.4,8,3,1,3,4,0,5,0.0,5,0,0,0,7,15,4,0,Matches,2021
133,Damien Da Silva,fr FRA,DF,Rennes,32,1988,5.8,3,2,3,0,0,2,4,50.0,2,5,4,1,8,11,25,0,Matches,2021
134,Colin Dagba,fr FRA,DF,Paris S-G,21,1998,2.5,7,5,6,1,0,6,15,40.0,9,6,2,4,3,10,11,0,Matches,2021
135,Mahmoud Dahoud,de GER,MF,Dortmund,24,1996,5.4,13,10,7,5,1,4,15,26.7,11,10,1,9,5,18,5,0,Matches,2021
136,Patson Daka,zm ZAM,FW,RB Salzburg,21,1998,2.3,5,2,1,2,2,0,2,0.0,2,6,0,6,0,5,1,0,Matches,2021
137,Danilo,br BRA,DF,Juventus,29,1991,6.3,18,10,11,7,0,13,18,72.2,5,7,3,4,20,38,10,0,Matches,2021
138,Matteo Darmian,it ITA,DF,Inter,30,1989,1.9,2,2,2,0,0,2,6,33.3,4,3,0,3,2,4,2,0,Matches,2021
139,Alphonso Davies,ca CAN,DF,Bayern Munich,19,2000,3.6,8,3,3,5,0,5,10,50.0,5,7,1,6,6,14,5,0,Matches,2021
140,Kevin De Bruyne,be BEL,"MF,FW",Manchester City,29,1991,7.4,9,3,1,4,4,4,20,20.0,16,12,2,10,2,11,2,0,Matches,2021
141,Charles De Ketelaere,be BEL,"FW,DF",Club Brugge,19,2001,5.1,11,8,4,4,3,5,11,45.5,6,16,1,15,3,14,3,0,Matches,2021
142,Konrad De La Fuente,us USA,FW,Barcelona,19,2001,0.2,0,0,0,0,0,0,0,,0,0,0,0,0,0,0,0,Matches,2021
143,Romain Del Castillo,fr FRA,"FW,MF",Rennes,24,1996,1.5,5,3,1,2,2,2,4,50.0,2,1,0,1,3,8,0,0,Matches,2021
144,Thomas Delaney,dk DEN,"MF,DF",Dortmund,28,1991,4.8,11,8,3,6,2,3,5,60.0,2,5,0,5,4,15,8,0,Matches,2021
145,Simon Deli,ci CIV,DF,Club Brugge,28,1991,3.5,1,0,1,0,0,1,2,50.0,1,4,4,0,5,6,12,1,Matches,2021
146,Moussa Dembélé,fr FRA,"FW,MF",Atlético Madrid,24,1996,0.5,0,0,0,0,0,0,0,,0,1,0,1,0,0,1,0,Matches,2021
147,Ousmane Dembélé,fr FRA,FW,Barcelona,23,1997,4.2,4,1,2,2,0,2,11,18.2,9,2,0,2,2,6,1,0,Matches,2021
148,Merih Demiral,tr TUR,DF,Juventus,22,1998,4.4,5,3,3,2,0,2,3,66.7,1,2,1,1,9,14,12,1,Matches,2021
149,Emmanuel Dennis,ng NGA,"FW,MF",Club Brugge,22,1997,3.8,3,1,2,1,0,0,2,0.0,2,4,0,4,1,4,0,0,Matches,2021
150,Dentinho,br BRA,FW,Shakhtar,31,1989,1.8,1,0,1,0,0,1,2,50.0,1,7,0,7,2,3,1,0,Matches,2021
151,Fabio Depaoli,it ITA,DF,Atalanta,23,1997,0.1,0,0,0,0,0,0,0,,0,0,0,0,0,0,1,0,Matches,2021
152,Sergiño Dest,us USA,DF,Barcelona,19,2000,6.5,9,7,3,5,1,5,10,50.0,5,6,1,5,2,11,7,0,Matches,2021
153,Ángel Di María,ar ARG,"FW,MF",Paris S-G,32,1988,7.7,15,10,5,8,2,7,23,30.4,16,9,1,8,8,23,2,0,Matches,2021
154,Abdou Diallo,sn SEN,DF,Paris S-G,24,1996,5.6,12,9,10,2,0,8,11,72.7,3,5,3,2,5,17,14,0,Matches,2021
155,Amad Diallo,ci CIV,FW,Atalanta,18,2002,0.3,0,0,0,0,0,0,0,,0,0,0,0,0,0,0,0,Matches,2021
156,Rúben Dias,pt POR,DF,Manchester City,23,1997,10.8,14,8,5,7,2,5,8,62.5,3,12,8,4,16,30,23,0,Matches,2021
157,Krépin Diatta,sn SEN,"MF,FW",Club Brugge,21,1999,4.6,10,5,5,5,0,2,4,50.0,2,2,0,2,5,15,1,0,Matches,2021
158,Luis Díaz,co COL,"FW,MF",Porto,23,1997,5.0,8,3,4,4,0,3,8,37.5,5,2,0,2,2,10,2,0,Matches,2021
159,Dénes Dibusz,hu HUN,GK,Ferencváros,29,1990,6.0,1,1,1,0,0,1,1,100.0,0,0,0,0,0,1,1,2,Matches,2021
160,Berat Djimsiti,al ALB,DF,Atalanta,27,1993,8.0,11,4,8,3,0,2,10,20.0,8,7,6,1,24,35,34,0,Matches,2021
161,Dodô,br BRA,DF,Shakhtar,21,1998,6.0,6,4,4,1,1,3,10,30.0,7,5,1,4,12,18,13,0,Matches,2021
162,Jeremy Doku,be BEL,"FW,MF",Rennes,18,2002,4.5,4,3,2,2,0,0,2,0.0,2,0,0,0,2,6,1,0,Matches,2021
163,Tommy Doyle,eng ENG,MF,Manchester City,18,2001,0.1,0,0,0,0,0,0,0,,0,1,0,1,0,0,0,0,Matches,2021
164,Mohamed Dräger,tn TUN,DF,Olympiacos,24,1996,0.7,3,2,1,1,1,1,1,100.0,0,2,0,2,0,3,6,0,Matches,2021
165,Radu Drăgușin,ro ROU,DF,Juventus,18,2002,0.2,0,0,0,0,0,0,0,,0,0,0,0,0,0,1,0,Matches,2021
166,Julian Draxler,de GER,"FW,MF",Paris S-G,26,1993,3.0,0,0,0,0,0,0,4,0.0,4,4,0,4,7,7,2,0,Matches,2021
167,Anders Dreyer,dk DEN,"FW,MF",Midtjylland,22,1998,5.5,1,1,0,0,1,1,8,12.5,7,6,0,6,4,5,1,0,Matches,2021
168,Sebastián Driussi,ar ARG,"MF,FW",Zenit,24,1996,3.1,7,3,5,2,0,4,14,28.6,10,2,0,2,3,10,2,0,Matches,2021
169,Hugo Duro,es ESP,FW,Real Madrid,20,1999,0.2,1,1,0,0,1,1,1,100.0,0,0,0,0,0,1,0,0,Matches,2021
170,Lasha Dvali,ge GEO,DF,Ferencváros,25,1995,4.1,3,2,2,1,0,2,4,50.0,2,2,0,2,12,15,10,0,Matches,2021
171,Paulo Dybala,ar ARG,"FW,MF",Juventus,26,1993,2.4,1,0,0,1,0,0,8,0.0,8,1,0,1,1,2,1,0,Matches,2021
172,Artem Dzyuba,ru RUS,FW,Zenit,31,1988,3.8,0,0,0,0,0,0,3,0.0,3,1,1,0,0,0,2,0,Matches,2021
173,Éder,pt POR,FW,Loko Moscow,32,1987,2.8,0,0,0,0,0,0,1,0.0,1,3,0,3,0,0,0,0,Matches,2021
174,Ederson,br BRA,GK,Manchester City,26,1993,12.0,0,0,0,0,0,0,1,0.0,1,0,0,0,0,0,5,1,Matches,2021
175,Jurgen Ekkelenkamp,nl NED,MF,Ajax,20,2000,1.0,1,0,0,0,1,0,2,0.0,2,2,0,2,2,3,0,0,Matches,2021
176,Nico Elvedi,ch SUI,DF,M'Gladbach,23,1996,6.9,15,6,13,2,0,5,5,100.0,0,13,7,6,11,26,32,0,Matches,2021
177,Breel Embolo,ch SUI,"FW,MF",M'Gladbach,23,1997,3.3,3,1,0,2,1,0,5,0.0,5,2,0,2,2,5,0,0,Matches,2021
178,Youssef En-Nesyri,ma MAR,FW,Sevilla,23,1997,4.3,1,0,0,1,0,0,1,0.0,1,1,0,1,2,3,7,0,Matches,2021
179,Alexandru Epureanu,md MDA,DF,Başakşehir,33,1986,4.5,2,2,0,2,0,2,5,40.0,3,6,5,1,10,12,21,1,Matches,2021
180,Christian Eriksen,dk DEN,"MF,FW",Inter,28,1992,1.1,0,0,0,0,0,0,1,0.0,1,0,0,0,3,3,0,0,Matches,2021
181,Aleksandr Erokhin,ru RUS,"MF,FW",Zenit,30,1989,3.0,6,3,0,4,2,1,4,25.0,3,3,0,3,4,10,2,0,Matches,2021
182,Gonzalo Escalante,ar ARG,MF,Lazio,27,1993,1.6,2,1,2,0,0,2,6,33.3,4,2,0,2,4,6,0,0,Matches,2021
183,Sergio Escudero,es ESP,DF,Sevilla,30,1989,2.0,1,0,1,0,0,0,1,0.0,1,2,0,2,2,3,1,0,Matches,2021
184,Evander,br BRA,"MF,FW",Midtjylland,22,1998,1.7,1,1,0,0,1,0,0,,0,1,0,1,1,2,0,0,Matches,2021
185,Evanilson,br BRA,"FW,DF",Porto,20,1999,0.9,0,0,0,0,0,0,1,0.0,1,1,0,1,0,0,2,0,Matches,2021
186,Fabinho,br BRA,"DF,MF",Liverpool,26,1993,6.2,19,13,11,7,1,10,14,71.4,4,10,3,7,13,32,28,0,Matches,2021
187,Mohamed Fares,dz ALG,DF,Lazio,24,1996,3.8,9,4,5,3,1,5,11,45.5,6,4,0,4,8,17,11,0,Matches,2021
188,Ansu Fati,es ESP,FW,Barcelona,17,2002,1.8,1,1,0,0,1,0,3,0.0,3,3,1,2,1,2,2,0,Matches,2021
189,Felipe,br BRA,DF,Atlético Madrid,31,1989,4.3,10,6,6,3,1,6,9,66.7,3,6,4,2,7,17,27,0,Matches,2021
190,Luiz Felipe,it ITA,DF,Lazio,23,1997,2.0,4,3,2,2,0,3,3,100.0,0,5,2,3,4,8,8,0,Matches,2021
191,João Félix,pt POR,"FW,MF",Atlético Madrid,20,1999,7.8,6,5,1,3,2,3,8,37.5,5,2,0,2,4,10,3,0,Matches,2021
192,Bruno Fernandes,pt POR,MF,Manchester Utd,25,1994,4.9,9,6,2,4,3,1,11,9.1,10,5,0,5,4,13,2,0,Matches,2021
193,Matheus Fernandes,br BRA,MF,Barcelona,22,1998,0.2,0,0,0,0,0,0,0,,0,0,0,0,0,0,0,0,Matches,2021
194,Carlos Fernández,es ESP,FW,Sevilla,24,1996,0.1,0,0,0,0,0,0,1,0.0,1,0,0,0,0,0,0,0,Matches,2021
195,Fernandinho,br BRA,MF,Manchester City,35,1985,3.8,9,2,0,6,3,4,9,44.4,5,7,1,6,7,16,4,1,Matches,2021
196,Fernando,br BRA,"MF,DF",Sevilla,33,1987,5.5,8,3,4,4,0,3,10,30.0,7,6,1,5,10,18,7,0,Matches,2021
197,Fernando,br BRA,FW,Shakhtar,21,1999,0.4,0,0,0,0,0,0,1,0.0,1,2,0,2,0,0,1,0,Matches,2021
198,Roberto Firmino,br BRA,"FW,MF",Liverpool,28,1991,3.7,3,2,3,0,0,1,4,25.0,3,5,0,5,2,5,4,0,Matches,2021
199,Junior Firpo,es ESP,DF,Barcelona,23,1996,2.9,7,4,2,3,2,2,3,66.7,1,5,2,3,2,9,3,1,Matches,2021
200,Alessandro Florenzi,it ITA,DF,Paris S-G,29,1991,9.0,11,6,8,3,0,2,14,14.3,12,7,3,4,10,21,17,0,Matches,2021
201,Phil Foden,eng ENG,"FW,MF",Manchester City,20,2000,11.8,16,10,5,5,6,7,15,46.7,8,13,1,12,9,25,3,1,Matches,2021
202,Emil Forsberg,se SWE,"MF,FW",RB Leipzig,28,1991,5.1,2,1,1,0,1,0,2,0.0,2,0,0,0,1,3,0,0,Matches,2021
203,Kostas Fortounis,gr GRE,"FW,MF",Olympiacos,27,1992,3.2,3,3,0,3,0,2,6,33.3,4,1,0,1,2,5,0,0,Matches,2021
204,Timothy Fosu-Mensah,nl NED,DF,Manchester Utd,22,1998,0.3,2,1,0,2,0,1,1,100.0,0,1,0,1,2,4,0,0,Matches,2021
205,Gianluca Frabotta,it ITA,DF,Juventus,21,1999,0.2,0,0,0,0,0,0,0,,0,0,0,0,0,0,0,0,Matches,2021
206,Lassina Franck Traoré,bf BFA,FW,Ajax,19,2001,2.2,0,0,0,0,0,0,0,,0,3,0,3,1,1,5,0,Matches,2021
207,Fred,br BRA,MF,Manchester Utd,27,1993,3.8,12,3,4,7,1,6,13,46.2,7,9,0,9,7,19,4,0,Matches,2021
208,Remo Freuler,ch SUI,MF,Atalanta,28,1992,5.8,19,8,6,10,3,8,19,42.1,11,7,1,6,11,30,6,0,Matches,2021
209,Abraham Frimpong,gh GHA,DF,Ferencváros,27,1993,2.0,4,2,3,1,0,1,3,33.3,2,6,3,3,4,8,4,1,Matches,2021
210,Roberto Gagliardini,it ITA,MF,Inter,26,1994,2.8,6,1,2,3,1,1,4,25.0,3,1,0,1,5,11,3,0,Matches,2021
211,Idrissa Gana Gueye,sn SEN,MF,Paris S-G,30,1989,5.4,18,10,9,7,2,3,9,33.3,6,14,2,12,5,23,9,0,Matches,2021
212,Eric García,es ESP,DF,Manchester City,19,2001,2.3,2,1,1,1,0,1,2,50.0,1,0,0,0,3,5,5,0,Matches,2021
213,Yuri Gazinskiy,ru RUS,MF,Krasnodar,31,1989,4.2,7,1,2,5,0,5,12,41.7,7,5,1,4,13,20,4,0,Matches,2021
214,Yann Gboho,fr FRA,MF,Rennes,19,2001,1.1,2,1,2,0,0,1,1,100.0,0,1,0,1,1,3,0,0,Matches,2021
215,David de Gea,es ESP,GK,Manchester Utd,29,1990,5.0,0,0,0,0,0,0,0,,0,0,0,0,0,0,3,0,Matches,2021
216,Valère Germain,fr FRA,"FW,MF",Marseille,30,1990,2.2,2,0,1,0,1,0,3,0.0,3,0,0,0,1,3,1,0,Matches,2021
217,Billy Gilmour,sct SCO,MF,Chelsea,19,2001,1.1,0,0,0,0,0,0,0,,0,0,0,0,2,2,1,0,Matches,2021
218,Matthias Ginter,de GER,DF,M'Gladbach,26,1994,8.0,3,3,2,1,0,2,4,50.0,2,9,7,2,5,8,27,0,Matches,2021
219,Olivier Giroud,fr FRA,FW,Chelsea,33,1986,2.9,2,1,0,1,1,0,0,,0,3,0,3,2,4,2,0,Matches,2021
220,Serge Gnabry,de GER,"FW,MF",Bayern Munich,25,1995,4.0,4,1,2,2,0,2,7,28.6,5,5,0,5,6,10,2,0,Matches,2021
221,Pierluigi Gollini,it ITA,GK,Atalanta,25,1995,3.0,0,0,0,0,0,0,0,,0,0,0,0,0,0,3,0,Matches,2021
222,Eulânio Ângelo Chipela Gomes,gw GNB,DF,Porto,26,1994,1.5,2,1,1,1,0,0,3,0.0,3,2,0,2,2,4,1,0,Matches,2021
223,Joe Gomez,eng ENG,DF,Liverpool,23,1997,3.0,4,2,3,1,0,1,4,25.0,3,0,0,0,5,9,19,0,Matches,2021
224,Papu Gómez,ar ARG,"MF,FW",Atalanta,32,1988,5.0,2,2,0,1,1,1,8,12.5,7,5,2,3,2,4,0,0,Matches,2021
225,Papu Gómez,ar ARG,"MF,FW",Sevilla,32,1988,1.0,1,1,0,1,0,1,2,50.0,1,1,0,1,1,2,0,0,Matches,2021
226,Sergi Gómez,es ESP,DF,Sevilla,28,1992,2.2,1,0,1,0,0,1,1,100.0,0,4,3,1,1,2,6,0,Matches,2021
227,Alfred Gomis,sn SEN,GK,Rennes,26,1993,4.0,0,0,0,0,0,0,0,,0,0,0,0,0,0,2,0,Matches,2021
228,Álvaro González,es ESP,DF,Marseille,30,1990,6.0,8,7,5,3,0,5,10,50.0,5,5,2,3,7,15,13,0,Matches,2021
229,Leon Goretzka,de GER,MF,Bayern Munich,25,1995,4.8,6,5,1,5,0,2,10,20.0,8,10,1,9,13,19,5,0,Matches,2021
230,Yevgeni Gorodov,ru RUS,GK,Krasnodar,34,1985,2.0,0,0,0,0,0,0,0,,0,0,0,0,0,0,0,0,Matches,2021
231,Robin Gosens,de GER,DF,Atalanta,26,1994,6.3,11,4,4,5,2,4,7,57.1,3,14,3,11,6,17,11,0,Matches,2021
232,Ryan Gravenberch,nl NED,MF,Ajax,18,2002,5.9,15,4,3,8,4,3,8,37.5,5,7,0,7,11,26,4,0,Matches,2021
233,Mason Greenwood,eng ENG,FW,Manchester Utd,18,2001,2.3,0,0,0,0,0,0,0,,0,1,0,1,1,1,0,0,Matches,2021
234,Clément Grenier,fr FRA,MF,Rennes,29,1991,2.5,8,5,1,6,1,2,5,40.0,3,2,0,2,2,10,0,0,Matches,2021
235,Antoine Griezmann,fr FRA,"FW,MF",Barcelona,29,1991,5.6,8,1,3,5,0,4,6,66.7,2,4,0,4,5,13,3,0,Matches,2021
236,Marko Grujić,rs SRB,MF,Porto,24,1996,4.3,11,2,6,2,3,6,13,46.2,7,8,3,5,5,16,8,0,Matches,2021
237,Nemanja Gudelj,rs SRB,"MF,DF",Sevilla,28,1991,5.5,7,3,4,3,0,1,3,33.3,2,7,5,2,4,11,5,1,Matches,2021
238,Raphaël Guerreiro,pt POR,DF,Dortmund,26,1993,7.4,7,4,4,3,0,4,6,66.7,2,3,0,3,5,12,6,0,Matches,2021
239,Pape Gueye,sn SEN,MF,Marseille,21,1999,1.9,4,3,2,2,0,2,2,100.0,0,1,0,1,7,11,2,0,Matches,2021
240,Serhou Guirassy,gn GUI,FW,Rennes,24,1996,3.8,1,0,1,0,0,1,2,50.0,1,2,0,2,1,2,2,0,Matches,2021
241,Péter Gulácsi,hu HUN,GK,RB Leipzig,30,1990,8.0,0,0,0,0,0,0,0,,0,0,0,0,0,0,4,0,Matches,2021
242,Fredrik Gulbrandsen,no NOR,FW,Başakşehir,27,1992,2.3,1,1,0,0,1,1,3,33.3,2,1,0,1,0,1,2,0,Matches,2021
243,İlkay Gündoğan,de GER,MF,Manchester City,29,1990,10.8,15,4,3,10,2,4,14,28.6,10,8,0,8,11,26,5,0,Matches,2021
244,Mert Günok,tr TUR,GK,Başakşehir,31,1989,6.0,0,0,0,0,0,0,0,,0,0,0,0,0,0,7,1,Matches,2021
245,Erling Haaland,no NOR,FW,Dortmund,20,2000,7.8,1,0,1,0,0,1,3,33.3,2,3,1,2,3,4,10,0,Matches,2021
246,Munir El Haddadi,ma MAR,"FW,MF",Sevilla,24,1995,3.3,4,1,2,2,0,1,3,33.3,2,2,0,2,1,5,0,0,Matches,2021
247,Amadou Haidara,ml MLI,"MF,DF",RB Leipzig,22,1998,4.7,16,8,4,11,1,10,20,50.0,10,8,0,8,9,25,4,0,Matches,2021
248,Achraf Hakimi,ma MAR,"DF,MF",Inter,21,1998,4.0,8,4,3,3,2,3,10,30.0,7,6,1,5,7,15,2,1,Matches,2021
249,Marcel Halstenberg,de GER,DF,RB Leipzig,28,1991,2.0,2,1,1,1,0,1,3,33.3,2,0,0,0,3,5,6,0,Matches,2021
250,Samir Handanović,si SVN,GK,Inter,36,1984,6.0,0,0,0,0,0,0,1,0.0,1,1,0,1,0,0,2,0,Matches,2021
251,Jesper Hansen,dk DEN,GK,Midtjylland,35,1985,4.0,0,0,0,0,0,0,0,,0,0,0,0,0,0,2,1,Matches,2021
252,Denys Harmash,ua UKR,"MF,FW",Dynamo Kyiv,30,1990,1.7,9,4,4,5,0,5,9,55.6,4,5,1,4,2,11,6,0,Matches,2021
253,Hans Hateboer,nl NED,DF,Atalanta,26,1994,5.9,9,4,5,2,2,6,15,40.0,9,6,1,5,7,16,9,0,Matches,2021
254,Kai Havertz,de GER,"MF,FW",Chelsea,21,1999,8.7,17,10,7,8,2,7,15,46.7,8,8,0,8,9,26,12,0,Matches,2021
255,Eden Hazard,be BEL,FW,Real Madrid,29,1991,3.0,0,0,0,0,0,0,0,,0,0,0,0,2,2,0,0,Matches,2021
256,Thorgan Hazard,be BEL,"FW,MF",Dortmund,27,1993,4.9,8,7,4,3,1,3,8,37.5,5,7,1,6,3,11,0,0,Matches,2021
257,Hwang Hee-chan,kr KOR,FW,RB Leipzig,24,1996,1.0,0,0,0,0,0,0,1,0.0,1,2,0,2,2,2,1,0,Matches,2021
258,Marcel Heister,de GER,DF,Ferencváros,28,1992,4.3,9,6,8,1,0,4,9,44.4,5,3,2,1,6,15,5,0,Matches,2021
259,Dean Henderson,eng ENG,GK,Manchester Utd,23,1997,1.0,0,0,0,0,0,0,0,,0,0,0,0,0,0,0,0,Matches,2021
260,Jordan Henderson,eng ENG,"MF,DF",Liverpool,30,1990,4.0,1,1,1,0,0,1,5,20.0,4,5,2,3,7,8,8,0,Matches,2021
261,Benjamin Henrichs,de GER,"DF,FW",RB Leipzig,23,1997,1.3,9,3,3,5,1,2,4,50.0,2,1,0,1,2,11,2,0,Matches,2021
262,Dalbert Henrique,br BRA,"DF,FW",Rennes,26,1993,2.5,2,1,1,1,0,2,5,40.0,3,2,1,1,2,4,2,0,Matches,2021
263,Luis Henrique,br BRA,"FW,MF",Marseille,18,2001,1.1,1,1,0,1,0,1,2,50.0,1,1,0,1,1,2,0,0,Matches,2021
264,Mario Hermoso,es ESP,DF,Atlético Madrid,25,1995,3.9,11,7,6,5,0,6,11,54.5,5,7,2,5,7,18,12,1,Matches,2021
265,Lucas Hernández,fr FRA,DF,Bayern Munich,24,1996,7.7,24,16,14,7,3,8,15,53.3,7,10,2,8,5,29,17,0,Matches,2021
266,Ander Herrera,es ESP,MF,Paris S-G,30,1989,6.0,20,12,5,13,2,6,21,28.6,15,25,7,18,13,33,11,0,Matches,2021
267,Héctor Herrera,mx MEX,MF,Atlético Madrid,30,1990,3.3,5,3,2,3,0,4,6,66.7,2,7,4,3,6,11,3,0,Matches,2021
268,Patrick Herrmann,de GER,"FW,MF",M'Gladbach,29,1991,0.7,0,0,0,0,0,0,2,0.0,2,3,0,3,1,1,2,0,Matches,2021
269,Marwin Hitz,ch SUI,GK,Dortmund,32,1987,6.0,1,0,1,0,0,0,0,,0,0,0,0,0,1,6,0,Matches,2021
270,Wesley Hoedt,nl NED,DF,Lazio,26,1994,5.4,14,8,14,0,0,10,13,76.9,3,4,0,4,7,21,31,1,Matches,2021
271,Jonas Hofmann,de GER,FW,M'Gladbach,28,1992,4.8,6,2,3,1,2,5,21,23.8,16,4,0,4,2,8,4,0,Matches,2021
272,José Holebas,gr GRE,DF,Olympiacos,36,1984,4.8,8,5,5,1,2,5,9,55.6,4,3,0,3,11,19,11,0,Matches,2021
273,Ethan Horvath,us USA,GK,Club Brugge,25,1995,1.0,0,0,0,0,0,0,0,,0,0,0,0,0,0,1,0,Matches,2021
274,Callum Hudson-Odoi,eng ENG,"FW,DF",Chelsea,19,2000,3.8,5,4,2,1,2,1,3,33.3,2,3,0,3,4,9,3,0,Matches,2021
275,Mats Hummels,de GER,DF,Dortmund,31,1988,8.8,12,5,10,2,0,7,12,58.3,5,17,10,7,19,31,46,1,Matches,2021
276,Adrien Hunou,fr FRA,"FW,MF",Rennes,26,1994,1.0,0,0,0,0,0,0,1,0.0,1,0,0,0,0,0,0,0,Matches,2021
277,Klaas-Jan Huntelaar,nl NED,FW,Ajax,36,1983,0.4,0,0,0,0,0,0,0,,0,0,0,0,0,0,0,0,Matches,2021
278,Daniel Høegh,dk DEN,DF,Midtjylland,29,1991,1.0,2,2,1,1,0,0,0,,0,3,2,1,4,6,10,0,Matches,2021
279,Mauro Icardi,ar ARG,FW,Paris S-G,27,1993,2.7,3,0,1,2,0,0,1,0.0,1,2,1,1,3,6,3,0,Matches,2021
280,Oussama Idrissi,ma MAR,"FW,DF",Sevilla,24,1996,1.7,6,4,0,4,2,2,9,22.2,7,1,1,0,0,6,3,0,Matches,2021
281,Odion Ighalo,ng NGA,DF,Manchester Utd,31,1989,0.0,0,0,0,0,0,0,0,,0,0,0,0,0,0,0,0,Matches,2021
282,Vladislav Ignatyev,ru RUS,"MF,FW",Loko Moscow,33,1987,4.3,12,5,9,1,2,4,20,20.0,16,9,2,7,7,19,13,0,Matches,2021
283,Josip Iličić,si SVN,"FW,MF",Atalanta,32,1988,3.1,5,2,3,0,2,4,8,50.0,4,1,0,1,1,6,1,0,Matches,2021
284,Ciro Immobile,it ITA,FW,Lazio,30,1990,4.6,2,1,0,2,0,0,4,0.0,4,3,0,3,1,3,0,0,Matches,2021
285,Nikita Iosifov,ru RUS,MF,Loko Moscow,19,2001,0.2,0,0,0,0,0,0,0,,0,0,0,0,0,0,0,0,Matches,2021
286,Isael,br BRA,"FW,MF",Ferencváros,32,1988,4.0,5,3,2,2,1,0,3,0.0,3,2,0,2,5,10,2,0,Matches,2021
287,Gustav Isaksen,dk DEN,"MF,FW",Midtjylland,19,2001,0.5,0,0,0,0,0,0,0,,0,3,0,3,2,2,0,0,Matches,2021
288,Isco,es ESP,"FW,MF",Real Madrid,28,1992,1.1,2,0,1,1,0,2,4,50.0,2,2,0,2,3,5,1,0,Matches,2021
289,Daniel James,wls WAL,FW,Manchester Utd,22,1997,0.4,0,0,0,0,0,0,1,0.0,1,1,0,1,0,0,0,0,Matches,2021
290,Manjrekar James,ca CAN,DF,Midtjylland,26,1993,1.0,5,4,4,1,0,3,5,60.0,2,5,1,4,3,8,3,0,Matches,2021
291,Reece James,eng ENG,DF,Chelsea,20,1999,6.3,22,15,16,5,1,11,19,57.9,8,11,3,8,4,26,24,0,Matches,2021
292,Tony Jantschke,de GER,DF,M'Gladbach,30,1990,0.6,0,0,0,0,0,0,1,0.0,1,2,2,0,2,2,1,0,Matches,2021
293,Gabriel Jesus,br BRA,FW,Manchester City,23,1997,3.0,3,0,0,1,2,0,3,0.0,3,6,0,6,2,5,0,0,Matches,2021
294,Curtis Jones,eng ENG,MF,Liverpool,19,2001,4.5,6,3,3,3,0,2,4,50.0,2,6,1,5,7,13,4,0,Matches,2021
295,Frenkie de Jong,nl NED,"MF,DF",Barcelona,23,1997,6.5,8,5,3,3,2,3,9,33.3,6,4,1,3,15,23,7,0,Matches,2021
296,Luuk de Jong,nl NED,FW,Sevilla,29,1990,4.2,3,1,1,1,1,2,4,50.0,2,3,0,3,1,4,1,0,Matches,2021
297,Joan Jordán,es ESP,MF,Sevilla,26,1994,4.5,11,7,3,4,4,7,15,46.7,8,1,0,1,6,17,3,0,Matches,2021
298,Jorginho,it ITA,MF,Chelsea,28,1991,11.4,26,17,8,14,4,13,35,37.1,22,18,5,13,26,52,14,0,Matches,2021
299,Diogo Jota,pt POR,FW,Liverpool,23,1996,6.0,6,2,3,3,0,1,8,12.5,7,7,1,6,2,8,2,0,Matches,2021
300,Luka Jović,rs SRB,FW,Real Madrid,22,1997,0.6,1,0,0,0,1,0,0,,0,0,0,0,0,1,0,0,Matches,2021
301,Vinicius Júnior,br BRA,FW,Real Madrid,20,2000,7.0,11,8,4,4,3,4,11,36.4,7,10,1,9,1,12,3,0,Matches,2021
302,Zlatko Junuzović,at AUT,MF,RB Salzburg,32,1987,5.1,15,9,4,10,1,7,15,46.7,8,10,2,8,13,28,3,0,Matches,2021
303,Sory Kaba,gn GUI,FW,Midtjylland,25,1995,5.1,6,3,1,2,3,3,4,75.0,1,4,0,4,3,9,5,0,Matches,2021
304,Ozan Kabak,tr TUR,DF,Liverpool,20,2000,3.5,6,3,5,1,0,1,2,50.0,1,10,5,5,6,12,6,1,Matches,2021
305,İrfan Kahveci,tr TUR,MF,Başakşehir,25,1995,5.4,8,3,3,4,1,5,9,55.6,4,7,2,5,3,11,0,0,Matches,2021
306,François Kamano,gn GUI,MF,Loko Moscow,24,1996,2.0,6,3,4,0,2,5,11,45.5,6,1,0,1,0,6,2,0,Matches,2021
307,Boubacar Kamara,fr FRA,MF,Marseille,20,1999,4.3,9,5,5,3,1,5,10,50.0,5,3,1,2,8,17,6,1,Matches,2021
308,Ruslan Kambolov,ru RUS,MF,Krasnodar,30,1990,0.2,0,0,0,0,0,0,0,,0,1,0,1,0,0,4,0,Matches,2021
309,Kevin Kampl,si SVN,MF,RB Leipzig,29,1990,4.1,7,4,4,2,1,3,11,27.3,8,5,0,5,6,13,6,0,Matches,2021
310,N'Golo Kanté,fr FRA,MF,Chelsea,29,1991,7.9,10,8,8,1,1,3,8,37.5,5,13,3,10,14,24,13,0,Matches,2021
311,Emre Kaplan,tr TUR,DF,Başakşehir,19,2001,0.1,1,1,1,0,0,1,2,50.0,1,0,0,0,1,2,0,0,Matches,2021
312,Oleksandr Karavayev,ua UKR,DF,Dynamo Kyiv,28,1992,2.5,0,0,0,0,0,0,0,,0,2,0,2,4,4,6,0,Matches,2021
313,Vyacheslav Karavayev,ru RUS,DF,Zenit,25,1995,3.1,5,4,4,1,0,5,7,71.4,2,2,0,2,3,8,7,0,Matches,2021
314,Moise Kean,it ITA,FW,Paris S-G,20,2000,4.9,2,1,1,1,0,1,3,33.3,2,4,0,4,3,5,4,0,Matches,2021
315,Tomasz Kędziora,pl POL,DF,Dynamo Kyiv,26,1994,6.0,8,7,4,4,0,6,11,54.5,5,6,0,6,14,22,19,0,Matches,2021
316,Thilo Kehrer,de GER,"DF,FW",Paris S-G,23,1996,0.8,1,1,1,0,0,1,2,50.0,1,1,1,0,2,3,1,0,Matches,2021
317,Naby Keïta,gn GUI,MF,Liverpool,25,1995,1.6,2,2,1,1,0,0,3,0.0,3,3,0,3,4,6,2,0,Matches,2021
318,Caoimhín Kelleher,ie IRL,GK,Liverpool,21,1998,2.0,0,0,0,0,0,0,0,,0,0,0,0,0,0,0,0,Matches,2021
319,Mikhail Kerzhakov,ru RUS,GK,Zenit,33,1987,6.0,0,0,0,0,0,0,0,,0,0,0,0,0,0,2,0,Matches,2021
320,Ihor Kharatin,ua UKR,MF,Ferencváros,25,1995,3.6,7,5,6,0,1,4,7,57.1,3,6,3,3,5,12,2,0,Matches,2021
321,Davit Khocholava,ge GEO,DF,Shakhtar,27,1993,3.3,1,1,1,0,0,1,4,25.0,3,4,3,1,7,8,21,0,Matches,2021
322,Joshua Kimmich,de GER,MF,Bayern Munich,25,1995,6.8,13,4,7,5,1,2,20,10.0,18,6,1,5,12,25,8,1,Matches,2021
323,Presnel Kimpembe,fr FRA,DF,Paris S-G,24,1995,10.9,13,7,9,4,0,2,8,25.0,6,9,4,5,5,18,41,1,Matches,2021
324,Davy Klaassen,nl NED,MF,Ajax,27,1993,5.0,9,5,5,3,1,6,9,66.7,3,4,0,4,6,15,11,1,Matches,2021
325,Sean Klaiber,sr SUR,DF,Ajax,26,1994,0.6,2,1,0,0,2,1,1,100.0,0,1,0,1,2,4,1,0,Matches,2021
326,Lukas Klostermann,de GER,DF,RB Leipzig,24,1996,2.0,2,2,1,1,0,1,3,33.3,2,0,0,0,4,6,9,0,Matches,2021
327,Justin Kluivert,nl NED,"MF,FW",RB Leipzig,21,1999,1.7,2,1,1,0,1,0,4,0.0,4,2,0,2,2,4,0,0,Matches,2021
328,Ansgar Knauff,de GER,FW,Dortmund,18,2002,1.5,5,1,1,4,0,4,6,66.7,2,1,0,1,1,6,3,0,Matches,2021
329,Sekou Koita,ml MLI,FW,RB Salzburg,20,1999,4.5,1,1,0,1,0,0,3,0.0,3,10,1,9,2,3,2,0,Matches,2021
330,Koka,eg EGY,FW,Olympiacos,27,1993,0.3,0,0,0,0,0,0,1,0.0,1,0,0,0,0,0,0,0,Matches,2021
331,Koke,es ESP,MF,Atlético Madrid,28,1992,7.4,16,10,6,5,5,10,30,33.3,20,9,3,6,11,27,4,0,Matches,2021
332,Aleksandar Kolarov,rs SRB,DF,Inter,34,1985,1.0,0,0,0,0,0,0,0,,0,2,2,0,1,1,1,0,Matches,2021
333,Ibrahima Konaté,fr FRA,DF,RB Leipzig,21,1999,5.3,10,3,6,4,0,3,7,42.9,4,7,5,2,7,17,12,0,Matches,2021
334,Viktor Korniienko,ua UKR,DF,Shakhtar,21,1999,3.0,0,0,0,0,0,0,1,0.0,1,3,2,1,4,4,7,0,Matches,2021
335,Odilon Kossonou,ci CIV,DF,Club Brugge,19,2001,5.0,9,5,7,2,0,4,7,57.1,3,10,5,5,9,18,6,0,Matches,2021
336,Billy Koumetio,fr FRA,DF,Liverpool,17,2002,0.5,0,0,0,0,0,0,1,0.0,1,0,0,0,3,3,7,0,Matches,2021
337,Jules Koundé,fr FRA,DF,Sevilla,21,1998,5.7,3,1,2,1,0,3,3,100.0,0,7,4,3,6,9,13,0,Matches,2021
338,Adnan Kovačević,ba BIH,DF,Ferencváros,26,1993,1.9,8,3,5,2,1,3,4,75.0,1,3,3,0,5,13,4,0,Matches,2021
339,Mateo Kovačić,hr CRO,MF,Chelsea,26,1994,6.7,13,11,7,6,0,8,16,50.0,8,4,0,4,7,20,5,0,Matches,2021
340,Viktor Kovalenko,ua UKR,MF,Shakhtar,24,1996,2.4,2,1,1,1,0,2,3,66.7,1,1,0,1,2,4,3,0,Matches,2021
341,Bozhidar Kraev,bg BUL,"MF,FW",Midtjylland,23,1997,0.6,1,0,0,1,0,1,3,33.3,2,1,0,1,1,2,0,0,Matches,2021
342,Christoph Kramer,de GER,MF,M'Gladbach,29,1991,6.9,9,5,4,5,0,3,19,15.8,16,12,4,8,11,20,6,0,Matches,2021
343,Michal Krmenčík,cz CZE,FW,Club Brugge,27,1993,0.8,1,0,0,0,1,1,1,100.0,0,1,0,1,0,1,2,0,Matches,2021
344,Toni Kroos,de GER,MF,Real Madrid,30,1990,10.7,19,6,10,8,1,9,26,34.6,17,11,2,9,19,38,3,0,Matches,2021
345,Danil Krugovoy,ru RUS,"DF,MF",Zenit,22,1998,1.8,0,0,0,0,0,0,4,0.0,4,2,0,2,4,4,3,0,Matches,2021
346,Grzegorz Krychowiak,pl POL,MF,Loko Moscow,30,1990,4.0,1,0,1,0,0,0,4,0.0,4,4,1,3,7,8,6,0,Matches,2021
347,Serhiy Kryvtsov,ua UKR,DF,Shakhtar,29,1991,1.0,2,2,2,0,0,1,1,100.0,0,1,0,1,3,5,1,0,Matches,2021
348,Daniil Kulikov,ru RUS,MF,Loko Moscow,22,1998,4.0,13,4,8,2,3,8,21,38.1,13,4,2,2,8,21,10,0,Matches,2021
349,Dejan Kulusevski,se SWE,"FW,MF",Juventus,20,2000,3.0,3,1,1,2,0,0,8,0.0,8,3,1,2,5,8,1,0,Matches,2021
350,Layvin Kurzawa,fr FRA,DF,Paris S-G,27,1992,4.2,14,10,8,3,3,8,11,72.7,3,7,1,6,8,22,13,0,Matches,2021
351,Daler Kuzyaev,ru RUS,"MF,FW",Zenit,27,1993,4.9,14,8,11,2,1,2,12,16.7,10,8,2,6,9,23,3,0,Matches,2021
352,Zakaria Labyad,ma MAR,MF,Ajax,27,1993,2.0,0,0,0,0,0,0,2,0.0,2,2,0,2,1,1,0,0,Matches,2021
353,Aïssa Laïdouni,tn TUN,MF,Ferencváros,23,1996,2.5,6,4,3,2,1,1,4,25.0,3,4,0,4,5,11,1,0,Matches,2021
354,Stefan Lainer,at AUT,DF,M'Gladbach,27,1992,7.6,21,12,8,8,5,13,19,68.4,6,16,3,13,11,32,25,0,Matches,2021
355,Sam Lammers,nl NED,FW,Atalanta,23,1997,0.1,0,0,0,0,0,0,0,,0,0,0,0,0,0,0,0,Matches,2021
356,Michael Lang,ch SUI,DF,M'Gladbach,29,1991,0.1,0,0,0,0,0,0,0,,0,0,0,0,1,1,0,0,Matches,2021
357,Noa Lang,nl NED,"MF,FW",Club Brugge,21,1999,3.3,4,4,0,3,1,1,2,50.0,1,0,0,0,1,5,2,0,Matches,2021
358,Aymeric Laporte,es ESP,DF,Manchester City,26,1994,3.1,2,1,1,1,0,1,2,50.0,1,1,1,0,4,6,9,0,Matches,2021
359,Valentino Lazaro,at AUT,"FW,DF",M'Gladbach,24,1996,2.7,7,3,5,2,0,5,6,83.3,1,5,1,4,2,9,2,0,Matches,2021
360,Manuel Lazzari,it ITA,DF,Lazio,26,1993,3.6,4,2,0,3,1,1,5,20.0,4,2,0,2,2,6,2,0,Matches,2021
361,James Lea Siliki,cm CMR,"MF,FW",Rennes,24,1996,2.4,4,2,2,2,0,1,5,20.0,4,3,0,3,1,5,3,0,Matches,2021
362,Diogo Leite,pt POR,DF,Porto,21,1999,2.0,0,0,0,0,0,0,0,,0,4,2,2,2,2,15,0,Matches,2021
363,Lucas Leiva,br BRA,MF,Lazio,33,1987,3.9,6,4,5,1,0,3,11,27.3,8,3,0,3,10,16,7,0,Matches,2021
364,Thomas Lemar,fr FRA,"DF,MF",Atlético Madrid,24,1995,2.1,5,2,2,3,0,4,7,57.1,3,4,0,4,0,5,3,0,Matches,2021
365,Clément Lenglet,fr FRA,DF,Barcelona,25,1995,6.2,7,3,4,2,1,3,8,37.5,5,1,0,1,11,18,13,1,Matches,2021
366,Robert Lewandowski,pl POL,FW,Bayern Munich,31,1988,5.7,2,1,1,0,1,1,2,50.0,1,6,1,5,2,4,4,0,Matches,2021
367,Bohdan Liedniev,ua UKR,MF,Dynamo Kyiv,22,1998,0.4,0,0,0,0,0,0,0,,0,3,0,3,0,0,0,0,Matches,2021
368,Matthijs de Ligt,nl NED,DF,Juventus,20,1999,4.5,9,6,5,3,1,3,3,100.0,0,8,6,2,7,16,10,0,Matches,2021
369,Victor Lindelöf,se SWE,DF,Manchester Utd,26,1994,4.4,4,2,2,2,0,3,4,75.0,1,6,4,2,3,7,11,0,Matches,2021
370,Vitaly Lisakovich,by BLR,"MF,FW",Loko Moscow,22,1998,0.8,0,0,0,0,0,0,0,,0,0,0,0,0,0,1,0,Matches,2021
371,Marcos Llorente,es ESP,"MF,DF",Atlético Madrid,25,1995,7.3,16,9,8,6,2,12,21,57.1,9,6,0,6,11,27,11,0,Matches,2021
372,Renan Lodi,br BRA,DF,Atlético Madrid,22,1998,4.2,11,8,6,3,2,3,5,60.0,2,8,0,8,8,19,9,0,Matches,2021
373,Dejan Lovren,hr CRO,DF,Zenit,31,1989,4.3,1,0,1,0,0,1,6,16.7,5,7,1,6,11,12,23,0,Matches,2021
374,Gergő Lovrencsics,hu HUN,DF,Ferencváros,31,1988,4.1,11,6,8,1,2,7,15,46.7,8,9,0,9,7,18,8,1,Matches,2021
375,José Luis Palomino,ar ARG,DF,Atalanta,30,1990,2.3,4,3,2,1,1,0,2,0.0,2,3,2,1,6,10,4,0,Matches,2021
376,Zé Luís,cv CPV,FW,Loko Moscow,29,1991,4.2,3,0,2,0,1,2,6,33.3,4,5,0,5,1,4,7,0,Matches,2021
377,Romelu Lukaku,be BEL,FW,Inter,27,1993,4.9,0,0,0,0,0,0,1,0.0,1,3,0,3,0,0,5,0,Matches,2021
378,Senad Lulić,ba BIH,DF,Lazio,34,1986,1.2,3,1,1,2,0,1,6,16.7,5,1,0,1,3,6,0,0,Matches,2021
379,Vitali Lystsov,ru RUS,DF,Loko Moscow,25,1995,0.5,3,0,3,0,0,0,2,0.0,2,1,0,1,0,3,4,0,Matches,2021
380,Yann M'Vila,fr FRA,MF,Olympiacos,30,1990,5.9,7,3,2,5,0,5,13,38.5,8,7,1,6,12,19,8,0,Matches,2021
381,Awer Mabil,au AUS,"FW,MF",Midtjylland,24,1995,5.0,5,3,3,1,1,2,10,20.0,8,3,0,3,4,9,2,0,Matches,2021
382,Nicolas Madsen,dk DEN,"MF,FW",Midtjylland,20,2000,1.0,1,1,0,1,0,1,2,50.0,1,2,1,1,4,5,4,0,Matches,2021
383,Stanislav Magkeev,ru RUS,MF,Loko Moscow,21,1999,2.2,4,2,3,1,0,2,5,40.0,3,1,0,1,7,11,4,0,Matches,2021
384,Harry Maguire,eng ENG,DF,Manchester Utd,27,1993,5.0,4,3,2,1,1,3,6,50.0,3,7,4,3,5,9,15,0,Matches,2021
385,Riyad Mahrez,dz ALG,"FW,MF",Manchester City,29,1991,9.0,13,7,0,7,6,5,15,33.3,10,11,2,9,6,19,3,0,Matches,2021
386,Róbert Mak,sk SVK,"MF,FW",Ferencváros,29,1991,1.0,1,0,1,0,0,0,0,,0,1,0,1,1,2,0,0,Matches,2021
387,Malcom,br BRA,"FW,MF",Zenit,23,1997,2.7,1,1,0,0,1,0,3,0.0,3,2,0,2,1,2,0,0,Matches,2021
388,Ruslan Malinovskyi,ua UKR,MF,Atalanta,27,1993,1.5,3,3,1,2,0,2,6,33.3,4,3,0,3,3,6,0,0,Matches,2021
389,Wilson Manafá,pt POR,DF,Porto,26,1994,8.3,15,10,10,4,1,4,12,33.3,8,9,3,6,7,22,21,0,Matches,2021
390,Steve Mandanda,fr FRA,GK,Marseille,35,1985,6.0,0,0,0,0,0,0,0,,0,0,0,0,0,0,2,0,Matches,2021
391,Sadio Mané,sn SEN,FW,Liverpool,28,1992,7.9,5,4,2,1,2,2,7,28.6,5,6,0,6,3,8,1,0,Matches,2021
392,Faitout Maouassa,fr FRA,DF,Rennes,22,1998,0.9,3,1,2,1,0,1,2,50.0,1,2,0,2,0,3,2,0,Matches,2021
393,Marcelo,br BRA,DF,Real Madrid,32,1988,1.8,5,3,0,3,2,4,4,100.0,0,1,0,1,0,5,0,0,Matches,2021
394,Agustín Marchesín,ar ARG,GK,Porto,32,1988,9.3,1,0,1,0,0,1,2,50.0,1,0,0,0,1,2,7,0,Matches,2021
395,Moussa Marega,ml MLI,FW,Porto,29,1991,8.2,9,4,1,5,3,3,5,60.0,2,7,1,6,5,14,11,0,Matches,2021
396,José María Giménez,uy URU,DF,Atlético Madrid,25,1995,3.7,5,5,4,1,0,3,5,60.0,2,4,1,3,6,11,14,0,Matches,2021
397,Mariano,do DOM,FW,Real Madrid,26,1993,1.2,0,0,0,0,0,0,1,0.0,1,1,0,1,0,0,0,0,Matches,2021
398,Guilherme Marinato,ru RUS,GK,Loko Moscow,34,1985,6.0,1,1,1,0,0,1,1,100.0,0,0,0,0,0,1,4,1,Matches,2021
399,João Mário Lopes,pt POR,"FW,MF",Porto,20,2000,0.9,0,0,0,0,0,0,0,,0,0,0,0,2,2,0,0,Matches,2021
400,Yevgeni Markov,ru RUS,FW,Krasnodar,26,1994,0.0,0,0,0,0,0,0,0,,0,0,0,0,0,0,0,0,Matches,2021
401,Marlos,ua UKR,MF,Shakhtar,32,1988,4.7,6,3,3,3,0,5,12,41.7,7,1,1,0,2,8,3,1,Matches,2021
402,Marquinhos,br BRA,"DF,MF",Paris S-G,26,1994,9.1,18,6,9,9,0,8,11,72.7,3,16,10,6,10,28,39,0,Matches,2021
403,Anthony Martial,fr FRA,FW,Manchester Utd,24,1995,4.7,0,0,0,0,0,0,1,0.0,1,2,0,2,3,3,3,0,Matches,2021
404,Jonas Martin,fr FRA,MF,Rennes,30,1990,1.0,2,0,1,1,0,1,2,50.0,1,2,0,2,1,3,0,0,Matches,2021
405,Javi Martínez,es ESP,MF,Bayern Munich,31,1988,2.1,2,1,1,1,0,0,2,0.0,2,3,1,2,11,13,5,0,Matches,2021
406,Lautaro Martínez,ar ARG,FW,Inter,22,1997,4.5,1,1,0,0,1,0,3,0.0,3,4,0,4,5,6,1,0,Matches,2021
407,Lisandro Martínez,ar ARG,DF,Ajax,22,1998,3.3,7,5,6,1,0,5,10,50.0,5,2,2,0,8,15,20,1,Matches,2021
408,Toni Martínez,es ESP,FW,Porto,23,1997,1.1,0,0,0,0,0,0,0,,0,2,0,2,1,1,7,0,Matches,2021
409,Alyaksandr Martynovich,by BLR,DF,Krasnodar,32,1987,5.0,3,1,1,0,2,1,3,33.3,2,6,4,2,9,12,26,0,Matches,2021
410,Adam Marušić,me MNE,DF,Lazio,27,1992,8.0,10,2,6,4,0,7,10,70.0,3,5,0,5,12,22,19,0,Matches,2021
411,Giorgos Masouras,gr GRE,"MF,FW",Olympiacos,26,1994,3.2,10,6,2,7,1,5,12,41.7,7,3,0,3,3,13,4,0,Matches,2021
412,Clinton Mata,ao ANG,DF,Club Brugge,27,1992,5.9,9,6,5,3,1,7,9,77.8,2,3,2,1,9,18,9,0,Matches,2021
413,Juan Mata,es ESP,FW,Manchester Utd,32,1988,0.7,0,0,0,0,0,0,0,,0,0,0,0,0,0,0,1,Matches,2021
414,Nemanja Matić,rs SRB,"MF,DF",Manchester Utd,31,1988,2.5,5,5,0,5,0,2,3,66.7,1,2,2,0,4,9,4,0,Matches,2021
415,Joël Matip,cm CMR,DF,Liverpool,28,1991,1.9,4,3,3,1,0,3,4,75.0,1,0,0,0,0,4,7,0,Matches,2021
416,Mykola Matviyenko,ua UKR,DF,Shakhtar,24,1996,3.3,10,5,8,2,0,7,13,53.8,6,1,0,1,11,21,14,1,Matches,2021
417,Eric Maxim Choupo-Moting,cm CMR,FW,Bayern Munich,31,1989,4.3,7,2,3,2,2,2,3,66.7,1,6,1,5,0,7,2,0,Matches,2021
418,Maycon,br BRA,MF,Shakhtar,23,1997,4.1,2,2,2,0,0,0,4,0.0,4,2,0,2,4,6,14,0,Matches,2021
419,Noussair Mazraoui,ma MAR,DF,Ajax,22,1997,5.3,19,12,10,6,3,7,13,53.8,6,12,4,8,14,33,15,0,Matches,2021
420,Kylian Mbappé,fr FRA,FW,Paris S-G,21,1998,10.0,2,1,2,0,0,0,5,0.0,5,1,0,1,1,3,7,0,Matches,2021
421,Chancel Mbemba,cd COD,DF,Porto,25,1994,10.3,13,10,12,1,0,8,8,100.0,0,13,10,3,8,21,49,0,Matches,2021
422,Weston McKennie,us USA,MF,Juventus,21,1998,4.5,13,10,5,6,2,4,13,30.8,9,6,0,6,3,16,3,0,Matches,2021
423,Scott McTominay,sct SCO,MF,Manchester Utd,23,1996,3.8,11,5,3,8,0,8,14,57.1,6,2,0,2,5,16,8,0,Matches,2021
424,Brandon Mechele,be BEL,DF,Club Brugge,27,1993,2.0,3,2,2,1,0,2,3,66.7,1,0,0,0,5,8,10,0,Matches,2021
425,Arthur Melo,br BRA,MF,Juventus,23,1996,3.7,7,6,4,2,1,4,8,50.0,4,1,0,1,2,9,1,0,Matches,2021
426,Benjamin Mendy,fr FRA,DF,Manchester City,26,1994,0.9,1,0,0,0,1,0,1,0.0,1,1,0,1,2,3,0,0,Matches,2021
427,Edouard Mendy,sn SEN,GK,Chelsea,28,1992,12.0,0,0,0,0,0,0,0,,0,0,0,0,0,0,3,1,Matches,2021
428,Ferland Mendy,fr FRA,DF,Real Madrid,25,1995,10.7,13,6,7,5,1,8,17,47.1,9,7,1,6,13,26,14,1,Matches,2021
429,Lionel Messi,ar ARG,"FW,MF",Barcelona,33,1987,6.0,5,2,0,2,3,2,7,28.6,5,2,0,2,2,7,0,0,Matches,2021
430,Thomas Meunier,be BEL,DF,Dortmund,28,1991,3.9,6,5,5,0,1,4,8,50.0,4,5,2,3,1,7,4,0,Matches,2021
431,Simon Mignolet,be BEL,GK,Club Brugge,32,1988,5.0,1,0,1,0,0,1,1,100.0,0,0,0,0,1,2,4,0,Matches,2021
432,Sergej Milinković-Savić,rs SRB,MF,Lazio,25,1995,6.5,9,5,5,4,0,3,13,23.1,10,10,2,8,15,24,10,2,Matches,2021
433,Éder Militão,br BRA,DF,Real Madrid,22,1998,5.3,20,12,12,6,2,8,12,66.7,4,11,6,5,10,30,18,0,Matches,2021
434,James Milner,eng ENG,MF,Liverpool,34,1986,4.0,14,9,2,10,2,10,18,55.6,8,7,0,7,8,22,4,0,Matches,2021
435,Takumi Minamino,jp JPN,"FW,MF",Liverpool,25,1995,2.1,3,2,0,1,2,1,7,14.3,6,5,0,5,0,3,2,0,Matches,2021
436,Óscar Mingueza,es ESP,DF,Barcelona,21,1999,2.7,6,2,5,1,0,5,7,71.4,2,3,2,1,10,16,1,0,Matches,2021
437,Aleksei Miranchuk,ru RUS,"MF,FW",Atalanta,24,1995,0.3,0,0,0,0,0,0,1,0.0,1,0,0,0,2,2,1,0,Matches,2021
438,Anton Miranchuk,ru RUS,"MF,FW",Loko Moscow,24,1995,5.1,3,3,2,1,0,1,7,14.3,6,4,1,3,4,7,4,0,Matches,2021
439,Luka Modrić,hr CRO,MF,Real Madrid,34,1985,10.1,13,7,8,4,1,8,26,30.8,18,3,2,1,18,31,1,0,Matches,2021
440,Kudus Mohammed,gh GHA,FW,Ajax,19,2000,0.1,0,0,0,0,0,0,0,,0,0,0,0,0,0,0,0,Matches,2021
441,Johan Mojica,co COL,DF,Atalanta,27,1992,1.1,0,0,0,0,0,0,0,,0,1,0,1,2,2,0,0,Matches,2021
442,Júnior Moraes,ua UKR,FW,Shakhtar,33,1987,1.8,3,1,0,1,2,1,2,50.0,1,1,0,1,1,4,0,0,Matches,2021
443,Álvaro Morata,es ESP,FW,Juventus,27,1992,6.6,4,2,0,3,1,0,2,0.0,2,8,1,7,4,8,2,0,Matches,2021
444,Mateu Morey,es ESP,,Dortmund,20,2000,5.0,,9,,,,,,,,,,,17,,,,Matches,2021
445,Ilaix Moriba,gn GUI,MF,Barcelona,17,2003,0.1,1,1,1,0,0,0,0,,0,0,0,0,0,1,0,0,Matches,2021
446,Andrei Mostovoy,ru RUS,"FW,DF",Zenit,22,1997,2.2,0,0,0,0,0,0,0,,0,1,0,1,1,1,0,0,Matches,2021
447,Youssoufa Moukoko,de GER,FW,Dortmund,15,2004,0.4,0,0,0,0,0,0,0,,0,2,0,2,0,0,0,0,Matches,2021
448,Mason Mount,eng ENG,MF,Chelsea,21,1999,8.4,16,8,7,8,1,5,14,35.7,9,10,0,10,10,26,1,0,Matches,2021
449,Maksim Mukhin,ru RUS,MF,Loko Moscow,18,2001,0.5,4,4,1,3,0,3,3,100.0,0,1,0,1,3,7,0,0,Matches,2021
450,Nordi Mukiele,fr FRA,DF,RB Leipzig,22,1997,6.1,14,9,9,4,1,7,15,46.7,8,9,1,8,19,33,16,3,Matches,2021
451,Thomas Müller,de GER,"MF,FW",Bayern Munich,30,1989,7.0,7,3,3,0,4,4,14,28.6,10,9,2,7,3,10,3,0,Matches,2021
452,Luis Muriel,co COL,"FW,MF",Atalanta,29,1991,3.9,6,2,1,2,3,2,8,25.0,6,2,0,2,0,6,1,0,Matches,2021
453,Vedat Muriqi,xk KVX,FW,Lazio,26,1994,2.0,2,0,1,1,0,2,4,50.0,2,1,0,1,3,5,1,0,Matches,2021
454,Mateo Musacchio,ar ARG,DF,Lazio,29,1990,0.3,1,1,1,0,0,0,0,,0,0,0,0,0,1,1,1,Matches,2021
455,Leon Musayev,ru RUS,"MF,DF",Zenit,21,1999,0.6,6,1,4,2,0,3,4,75.0,1,0,0,0,1,7,1,0,Matches,2021
456,Jamal Musiala,de GER,MF,Bayern Munich,17,2003,2.6,9,6,3,3,3,2,9,22.2,7,2,0,2,1,10,0,0,Matches,2021
457,Enock Mwepu,zm ZAM,"MF,FW",RB Salzburg,22,1998,5.8,17,5,7,8,2,6,21,28.6,15,6,0,6,8,25,5,0,Matches,2021
458,Vitaliy Mykolenko,ua UKR,DF,Dynamo Kyiv,21,1999,3.9,5,3,3,2,0,5,8,62.5,3,2,0,2,12,17,11,0,Matches,2021
459,Joakim Mæhle,dk DEN,DF,Atalanta,23,1997,1.9,6,4,3,3,0,3,5,60.0,2,4,1,3,3,9,0,0,Matches,2021
460,Mamadou N'Diaye,,MF,Porto,23,1996,0.1,,1,,,,,,,,,,,0,,,,Matches,2021
461,Nacho,es ESP,DF,Real Madrid,30,1990,8.0,18,8,12,5,1,11,21,52.4,10,8,1,7,12,30,20,0,Matches,2021
462,Yuto Nagatomo,jp JPN,DF,Marseille,33,1986,1.1,0,0,0,0,0,0,0,,0,2,1,1,0,0,1,0,Matches,2021
463,Radja Nainggolan,be BEL,MF,Inter,32,1988,0.0,0,0,0,0,0,0,0,,0,0,0,0,0,0,0,0,Matches,2021
464,Shoya Nakajima,jp JPN,"FW,MF",Porto,25,1994,0.8,1,0,1,0,0,0,5,0.0,5,1,0,1,0,1,0,0,Matches,2021
465,Jesús Navas,es ESP,DF,Sevilla,34,1985,5.1,4,4,2,1,1,3,5,60.0,2,1,0,1,7,11,2,0,Matches,2021
466,Keylor Navas,cr CRC,GK,Paris S-G,33,1986,12.0,0,0,0,0,0,0,1,0.0,1,0,0,0,1,1,2,1,Matches,2021
467,David Neres,br BRA,FW,Ajax,23,1997,3.4,6,4,1,3,2,1,4,25.0,3,7,0,7,0,6,0,0,Matches,2021
468,Ruslan Neshcheret,ua UKR,GK,Dynamo Kyiv,18,2002,1.0,0,0,0,0,0,0,0,,0,0,0,0,0,0,0,0,Matches,2021
469,Neto,br BRA,GK,Barcelona,31,1989,3.0,0,0,0,0,0,0,0,,0,0,0,0,0,0,0,0,Matches,2021
470,Manuel Neuer,de GER,GK,Bayern Munich,34,1986,8.0,0,0,0,0,0,0,1,0.0,1,0,0,0,0,0,5,1,Matches,2021
471,Florian Neuhaus,de GER,MF,M'Gladbach,23,1997,7.8,24,12,13,8,3,15,22,68.2,7,9,3,6,9,33,8,0,Matches,2021
472,Neymar,br BRA,"FW,MF",Paris S-G,28,1992,8.3,5,3,1,3,1,2,14,14.3,12,5,1,4,3,8,0,0,Matches,2021
473,Tokmac Nguen,no NOR,"FW,MF",Ferencváros,26,1993,5.1,1,0,0,1,0,0,3,0.0,3,2,0,2,1,2,0,0,Matches,2021
474,M'Baye Niang,sn SEN,FW,Rennes,25,1994,1.1,1,1,0,0,1,0,1,0.0,1,1,0,1,0,1,1,0,Matches,2021
475,Saúl Ñíguez,es ESP,MF,Atlético Madrid,25,1994,5.1,8,4,2,5,1,3,12,25.0,9,6,3,3,12,20,9,0,Matches,2021
476,Rasmus Nissen,dk DEN,DF,RB Salzburg,23,1997,5.0,13,7,10,2,1,10,13,76.9,3,7,3,4,13,26,17,0,Matches,2021
477,Christopher Nkunku,fr FRA,"MF,FW",RB Leipzig,22,1997,6.5,18,17,4,7,7,8,14,57.1,6,15,0,15,8,26,2,0,Matches,2021
478,Felix Nmecha,de GER,MF,Manchester City,19,2000,0.1,0,0,0,0,0,0,0,,0,1,0,1,0,0,0,0,Matches,2021
479,Alexander Nübel,de GER,GK,Bayern Munich,23,1996,2.0,0,0,0,0,0,0,0,,0,0,0,0,0,0,1,0,Matches,2021
480,Gerzino Nyamsi,fr FRA,DF,Rennes,23,1997,2.0,4,3,1,3,0,3,3,100.0,0,0,0,0,6,10,3,0,Matches,2021
481,Steven Nzonzi,fr FRA,MF,Rennes,31,1988,4.7,3,2,1,2,0,1,5,20.0,4,0,0,0,2,5,6,0,Matches,2021
482,Jan Oblak,si SVN,GK,Atlético Madrid,27,1993,8.0,0,0,0,0,0,0,0,,0,0,0,0,0,0,1,0,Matches,2021
483,Lucas Ocampos,ar ARG,"FW,DF",Sevilla,26,1994,5.0,4,0,0,1,3,1,13,7.7,12,12,1,11,6,10,4,0,Matches,2021
484,Álvaro Odriozola,es ESP,DF,Real Madrid,24,1995,0.4,4,3,3,1,0,1,1,100.0,0,1,0,1,1,5,1,0,Matches,2021
485,Noah Okafor,ch SUI,"FW,MF",RB Salzburg,20,2000,0.6,3,2,0,3,0,1,1,100.0,0,1,0,1,0,3,1,0,Matches,2021
486,David Okereke,ng NGA,"MF,FW",Club Brugge,22,1997,0.3,0,0,0,0,0,0,3,0.0,3,0,0,0,0,0,0,0,Matches,2021
487,Masaya Okugawa,jp JPN,"MF,FW",RB Salzburg,24,1996,0.5,1,0,0,1,0,0,0,,0,0,0,0,1,2,0,0,Matches,2021
488,Sérgio Oliveira,pt POR,MF,Porto,28,1992,8.2,15,10,6,8,1,5,25,20.0,20,12,1,11,4,19,8,0,Matches,2021
489,Dani Olmo,es ESP,"FW,MF",RB Leipzig,22,1998,6.5,10,7,2,7,1,3,12,25.0,9,6,0,6,6,16,3,0,Matches,2021
490,Kristoffer Olsson,se SWE,"MF,FW",Krasnodar,25,1995,4.5,4,2,2,2,0,2,9,22.2,7,9,3,6,7,11,4,0,Matches,2021
491,André Onana,cm CMR,GK,Ajax,24,1996,6.0,0,0,0,0,0,0,1,0.0,1,0,0,0,0,0,0,2,Matches,2021
492,Jérôme Onguéné,cm CMR,DF,RB Salzburg,22,1997,0.5,0,0,0,0,0,0,0,,0,1,0,1,3,3,5,0,Matches,2021
493,Frank Onyeka,ng NGA,MF,Midtjylland,22,1998,5.6,18,12,8,9,1,5,15,33.3,10,8,1,7,18,36,9,0,Matches,2021
494,Willi Orban,hu HUN,DF,RB Leipzig,27,1992,3.6,9,5,6,3,0,5,12,41.7,7,5,2,3,3,12,10,1,Matches,2021
495,Divock Origi,be BEL,FW,Liverpool,25,1995,2.3,2,2,0,2,0,1,4,25.0,3,2,0,2,0,2,3,0,Matches,2021
496,Otávio,pt POR,"MF,FW",Porto,25,1995,7.8,24,16,11,9,4,12,31,38.7,19,7,1,6,0,24,10,0,Matches,2021
497,Alex Oxlade-Chamberlain,eng ENG,MF,Liverpool,26,1993,0.3,1,1,0,0,1,0,0,,0,0,0,0,0,1,0,0,Matches,2021
498,Berkay Özcan,tr TUR,MF,Başakşehir,22,1998,4.9,11,7,7,4,0,5,11,45.5,6,8,4,4,5,16,3,0,Matches,2021
499,Magomed Ozdoyev,ru RUS,MF,Zenit,27,1992,3.5,10,4,3,4,3,3,7,42.9,4,5,1,4,9,19,2,0,Matches,2021
500,Cole Palmer,eng ENG,FW,Manchester City,18,2002,0.1,0,0,0,0,0,0,0,,0,0,0,0,0,0,0,0,Matches,2021
501,Emerson Palmieri,it ITA,DF,Chelsea,25,1994,2.4,7,4,4,1,2,4,6,66.7,2,3,0,3,3,10,4,0,Matches,2021
502,Kaio Pantaleão,br BRA,DF,Krasnodar,24,1995,5.8,8,4,7,1,0,3,9,33.3,6,9,6,3,13,21,19,1,Matches,2021
503,Leandro Paredes,ar ARG,MF,Paris S-G,26,1994,7.4,18,5,6,10,2,8,25,32.0,17,7,2,5,18,36,10,1,Matches,2021
504,Marco Parolo,it ITA,"MF,DF",Lazio,35,1985,2.7,5,3,2,3,0,3,5,60.0,2,9,2,7,5,10,9,0,Matches,2021
505,Mario Pašalić,hr CRO,MF,Atalanta,25,1995,3.1,3,3,2,1,0,0,5,0.0,5,2,0,2,5,8,3,1,Matches,2021
506,Felix Passlack,de GER,"FW,DF",Dortmund,22,1998,1.3,1,1,0,1,0,0,0,,0,3,0,3,0,1,2,0,Matches,2021
507,Alfonso Pastor,es ESP,GK,Sevilla,19,2000,1.0,0,0,0,0,0,0,0,,0,0,0,0,0,0,1,0,Matches,2021
508,Patric,es ESP,DF,Lazio,27,1993,4.7,5,2,3,2,0,3,10,30.0,7,3,2,1,6,11,18,1,Matches,2021
509,Alan Patrick,br BRA,MF,Shakhtar,29,1991,1.8,5,2,2,2,1,3,8,37.5,5,3,0,3,2,7,3,0,Matches,2021
510,Giuliano de Paula,br BRA,"MF,FW",Başakşehir,30,1990,0.9,1,0,0,1,0,1,6,16.7,5,1,0,1,0,1,0,0,Matches,2021
511,Paulinho,br BRA,DF,Midtjylland,25,1995,5.3,11,9,7,2,2,4,7,57.1,3,5,0,5,11,22,8,0,Matches,2021
512,Benjamin Pavard,fr FRA,DF,Bayern Munich,24,1996,6.3,12,5,4,7,1,6,10,60.0,4,5,0,5,10,22,16,0,Matches,2021
513,Dimitri Payet,fr FRA,"FW,MF",Marseille,33,1987,3.8,3,2,1,1,1,0,0,,0,3,0,3,1,4,1,0,Matches,2021
514,Pedri,es ESP,"MF,FW",Barcelona,17,2002,5.5,12,7,5,4,3,6,18,33.3,12,13,2,11,5,17,3,0,Matches,2021
515,Timothee Pembele,fr FRA,DF,Paris S-G,17,2002,0.1,0,0,0,0,0,0,1,0.0,1,0,0,0,0,0,1,0,Matches,2021
516,Carlos de Pena,uy URU,"MF,FW",Dynamo Kyiv,28,1992,3.6,7,5,3,3,1,2,6,33.3,4,9,0,9,7,14,7,0,Matches,2021
517,Pepe,pt POR,DF,Porto,37,1983,6.3,6,5,5,1,0,5,9,55.6,4,9,6,3,4,10,32,0,Matches,2021
518,Andreas Pereira,br BRA,"MF,FW",Lazio,24,1996,1.5,6,4,1,5,0,3,6,50.0,3,5,0,5,1,7,0,0,Matches,2021
519,Danilo Pereira,pt POR,"DF,MF",Paris S-G,28,1991,8.7,10,7,9,0,1,3,8,37.5,5,11,6,5,20,30,44,0,Matches,2021
520,Ivan Perišić,hr CRO,"DF,FW",Inter,31,1989,2.7,2,1,0,2,0,0,6,0.0,6,1,0,1,3,5,3,0,Matches,2021
521,Matteo Pessina,it ITA,MF,Atalanta,23,1997,5.4,9,4,5,2,2,5,11,45.5,6,8,4,4,11,20,2,0,Matches,2021
522,Sergei Petrov,ru RUS,DF,Krasnodar,29,1991,0.8,1,1,0,1,0,1,1,100.0,0,0,0,0,0,1,0,0,Matches,2021
523,Luca Pfeiffer,de GER,"FW,MF",Midtjylland,23,1996,0.2,0,0,0,0,0,0,0,,0,0,0,0,0,0,0,0,Matches,2021
524,Nathaniel Phillips,eng ENG,DF,Liverpool,23,1997,3.0,5,3,3,2,0,2,5,40.0,3,8,4,4,6,11,11,0,Matches,2021
525,Andrea Pinamonti,it ITA,FW,Inter,21,1999,0.1,0,0,0,0,0,0,1,0.0,1,0,0,0,0,0,0,0,Matches,2021
526,Gerard Piqué,es ESP,DF,Barcelona,33,1987,2.6,3,2,0,3,0,1,1,100.0,0,3,2,1,3,6,6,0,Matches,2021
527,Łukasz Piszczek,pl POL,DF,Dortmund,35,1985,2.5,0,0,0,0,0,0,3,0.0,3,1,1,0,4,4,3,0,Matches,2021
528,Miralem Pjanić,ba BIH,MF,Barcelona,30,1990,5.5,4,3,1,1,2,2,10,20.0,8,5,0,5,12,16,2,1,Matches,2021
529,Alassane Pléa,fr FRA,FW,M'Gladbach,27,1993,6.0,2,0,0,2,0,1,4,25.0,3,5,0,5,2,4,0,0,Matches,2021
530,Paul Pogba,fr FRA,MF,Manchester Utd,27,1993,2.0,3,2,0,2,1,1,5,20.0,4,3,0,3,3,6,3,0,Matches,2021
531,Carlos Ponck,cv CPV,DF,Başakşehir,25,1995,2.1,1,0,1,0,0,1,7,14.3,6,5,2,3,6,7,8,0,Matches,2021
532,Denys Popov,ua UKR,DF,Dynamo Kyiv,21,1999,4.6,5,2,3,2,0,2,5,40.0,3,5,4,1,12,17,20,0,Matches,2021
533,Yussuf Poulsen,dk DEN,FW,RB Leipzig,26,1994,5.6,5,4,0,4,1,4,13,30.8,9,9,2,7,3,8,7,0,Matches,2021
534,Danila Prokhin,ru RUS,DF,Zenit,19,2001,2.0,2,2,2,0,0,2,4,50.0,2,2,2,0,6,8,8,1,Matches,2021
535,Quincy Promes,nl NED,"FW,DF",Ajax,28,1992,2.8,4,3,1,0,3,2,5,40.0,3,0,0,0,2,6,1,0,Matches,2021
536,Riqui Puig,es ESP,"MF,FW",Barcelona,20,1999,1.0,1,0,0,0,1,0,0,,0,1,0,1,2,3,0,0,Matches,2021
537,Christian Pulisic,us USA,"FW,MF",Chelsea,21,1998,4.7,6,4,2,3,1,3,6,50.0,3,7,1,6,3,9,0,0,Matches,2021
538,Andriy Pyatov,ua UKR,GK,Shakhtar,36,1984,1.0,0,0,0,0,0,0,0,,0,0,0,0,0,0,1,0,Matches,2021
539,Adrien Rabiot,fr FRA,MF,Juventus,25,1995,5.6,18,12,8,7,3,7,15,46.7,8,3,0,3,16,34,5,0,Matches,2021
540,Nemanja Radonjić,rs SRB,"FW,MF",Marseille,24,1996,1.0,0,0,0,0,0,0,0,,0,0,0,0,0,0,0,0,Matches,2021
541,Ștefan Radu,ro ROU,DF,Lazio,33,1986,1.5,2,1,0,1,1,1,1,100.0,0,2,2,0,2,4,6,0,Matches,2021
542,Rafael,br BRA,DF,Başakşehir,30,1990,5.7,21,9,11,8,2,9,26,34.6,17,13,2,11,12,33,12,0,Matches,2021
543,Rafinha,br BRA,DF,Olympiacos,34,1985,6.0,5,4,4,1,0,1,7,14.3,6,2,0,2,3,8,5,0,Matches,2021
544,Rafinha,br BRA,MF,Paris S-G,27,1993,1.4,2,0,0,1,1,2,2,100.0,0,3,1,2,3,5,2,0,Matches,2021
545,Slobodan Rajković,rs SRB,DF,Loko Moscow,31,1989,3.0,0,0,0,0,0,0,0,,0,9,9,0,6,6,22,0,Matches,2021
546,Ivan Rakitić,hr CRO,MF,Sevilla,32,1988,5.1,8,5,3,3,2,4,12,33.3,8,5,1,4,6,14,5,0,Matches,2021
547,Yaroslav Rakitskiy,ua UKR,DF,Zenit,30,1989,5.2,3,3,0,2,1,1,4,25.0,3,6,5,1,9,12,15,0,Matches,2021
548,André Ramalho,br BRA,DF,RB Salzburg,28,1992,6.0,8,3,4,4,0,3,6,50.0,3,10,5,5,12,20,30,0,Matches,2021
549,Cristian Ramírez,ec ECU,"DF,MF",Krasnodar,25,1994,5.5,9,6,5,1,3,4,7,57.1,3,6,3,3,5,14,12,1,Matches,2021
550,Sergio Ramos,es ESP,DF,Real Madrid,34,1986,4.7,2,1,2,0,0,2,3,66.7,1,5,2,3,7,9,10,0,Matches,2021
551,Aaron Ramsey,wls WAL,"MF,FW",Juventus,29,1990,4.0,4,2,2,1,1,1,6,16.7,5,1,0,1,9,13,4,0,Matches,2021
552,Lazar Ranđelović,rs SRB,"FW,MF",Olympiacos,22,1997,2.6,7,4,2,5,0,1,3,33.3,2,0,0,0,3,10,1,0,Matches,2021
553,Marcus Rashford,eng ENG,FW,Manchester Utd,22,1997,4.6,1,1,0,1,0,1,5,20.0,4,3,0,3,0,1,3,0,Matches,2021
554,Pepe Reina,es ESP,GK,Lazio,37,1982,7.0,0,0,0,0,0,0,1,0.0,1,0,0,0,2,2,2,1,Matches,2021
555,Reinier,br BRA,"MF,FW",Dortmund,18,2002,0.2,0,0,0,0,0,0,0,,0,0,0,0,0,0,0,0,Matches,2021
556,Karim Rekik,nl NED,DF,Sevilla,25,1994,2.4,3,1,0,2,1,2,4,50.0,2,2,1,1,4,7,5,0,Matches,2021
557,Marco Reus,de GER,"FW,MF",Dortmund,31,1989,7.7,12,8,5,6,1,3,11,27.3,8,8,2,6,7,19,7,0,Matches,2021
558,Gio Reyna,us USA,"MF,FW",Dortmund,17,2002,5.1,4,1,1,2,1,1,7,14.3,6,2,1,1,4,8,5,0,Matches,2021
559,Federico Ricca,uy URU,DF,Club Brugge,25,1994,3.0,5,2,3,2,0,1,2,50.0,1,6,4,2,5,10,10,0,Matches,2021
560,Chris Richards,us USA,DF,Bayern Munich,20,2000,1.4,8,4,3,3,2,3,4,75.0,1,1,1,0,2,10,3,0,Matches,2021
561,Mats Rits,be BEL,MF,Club Brugge,27,1993,3.6,1,0,1,0,0,0,2,0.0,2,1,0,1,8,9,8,0,Matches,2021
562,Sergi Roberto,es ESP,"DF,MF",Barcelona,28,1992,2.0,6,5,2,3,1,3,5,60.0,2,0,0,0,4,10,2,0,Matches,2021
563,Andrew Robertson,sct SCO,DF,Liverpool,26,1994,8.4,6,3,4,1,1,3,8,37.5,5,7,1,6,6,12,12,0,Matches,2021
564,Marc Roca,es ESP,MF,Bayern Munich,23,1996,1.7,1,0,0,1,0,0,0,,0,2,0,2,2,3,4,0,Matches,2021
565,Rodri,es ESP,MF,Manchester City,24,1996,8.7,11,8,2,8,1,4,16,25.0,12,7,1,6,9,20,9,2,Matches,2021
566,Gerson Rodrigues,lu LUX,"FW,MF",Dynamo Kyiv,25,1995,2.0,5,1,3,0,2,0,5,0.0,5,5,0,5,3,8,4,0,Matches,2021
567,Pedro Rodrigues,pt POR,MF,Olympiacos,23,1997,1.4,0,0,0,0,0,0,3,0.0,3,1,0,1,1,1,1,0,Matches,2021
568,Óscar Rodríguez Arnaiz,es ESP,MF,Sevilla,22,1998,3.1,7,5,1,5,1,1,9,11.1,8,4,1,3,2,9,0,0,Matches,2021
569,Rodrygo,br BRA,"FW,MF",Real Madrid,19,2001,3.6,7,2,5,2,0,4,9,44.4,5,5,0,5,2,9,2,0,Matches,2021
570,Cristian Romero,ar ARG,DF,Atalanta,22,1998,6.9,18,9,13,3,2,4,13,30.8,9,19,6,13,30,48,28,0,Matches,2021
571,Cristiano Ronaldo,pt POR,FW,Juventus,35,1985,6.3,0,0,0,0,0,0,3,0.0,3,1,1,0,2,2,5,0,Matches,2021
572,Valentin Rongier,fr FRA,MF,Marseille,25,1994,4.9,11,8,4,6,1,6,9,66.7,3,7,0,7,20,31,3,1,Matches,2021
573,Marten de Roon,nl NED,MF,Atalanta,29,1991,5.3,10,9,2,7,1,4,18,22.2,14,5,0,5,12,22,6,0,Matches,2021
574,Antonio Rüdiger,de GER,DF,Chelsea,27,1993,10.3,6,4,2,3,1,4,7,57.1,3,13,8,5,5,11,40,0,Matches,2021
575,Daniele Rugani,it ITA,DF,Rennes,26,1994,0.2,0,0,0,0,0,0,0,,0,1,1,0,0,0,3,0,Matches,2021
576,Matteo Ruggeri,it ITA,"DF,MF",Atalanta,18,2002,0.2,0,0,0,0,0,0,0,,0,0,0,0,1,1,0,0,Matches,2021
577,Georginio Rutter,fr FRA,FW,Rennes,18,2002,0.2,2,2,1,0,1,0,0,,0,0,0,0,0,2,0,0,Matches,2021
578,Dmitrii Rybchinskii,ru RUS,MF,Loko Moscow,21,1998,1.7,5,4,5,0,0,4,7,57.1,3,1,0,1,8,13,3,0,Matches,2021
579,Maciej Rybus,pl POL,DF,Loko Moscow,30,1989,6.0,5,3,4,1,0,2,9,22.2,7,5,3,2,16,21,29,0,Matches,2021
580,José Sá,pt POR,GK,Olympiacos,27,1993,6.0,0,0,0,0,0,0,0,,0,0,0,0,2,2,2,0,Matches,2021
581,Marcel Sabitzer,at AUT,MF,RB Leipzig,26,1994,6.3,14,6,4,10,0,7,18,38.9,11,5,3,2,12,26,8,1,Matches,2021
582,Leon Sabua,ru RUS,FW,Krasnodar,19,2000,0.4,0,0,0,0,0,0,0,,0,0,0,0,0,0,0,0,Matches,2021
583,Matvei Safonov,ru RUS,GK,Krasnodar,21,1999,4.0,0,0,0,0,0,0,0,,0,0,0,0,0,0,2,1,Matches,2021
584,Hiroki Sakai,jp JPN,DF,Marseille,30,1990,6.0,9,8,7,2,0,3,8,37.5,5,8,1,7,12,21,10,1,Matches,2021
585,Mohamed Salah,eg EGY,FW,Liverpool,28,1992,8.6,6,6,1,4,1,2,8,25.0,6,6,0,6,5,11,3,1,Matches,2021
586,Romain Salin,fr FRA,GK,Rennes,36,1984,2.0,0,0,0,0,0,0,0,,0,0,0,0,0,0,1,0,Matches,2021
587,Alexis Sánchez,cl CHI,"FW,MF",Inter,31,1988,1.3,2,1,1,0,1,0,1,0.0,1,1,0,1,3,5,0,0,Matches,2021
588,Jadon Sancho,eng ENG,"FW,MF",Dortmund,20,2000,4.3,3,1,2,0,1,1,4,25.0,3,0,0,0,4,7,1,0,Matches,2021
589,Alex Sandro,br BRA,DF,Juventus,29,1991,5.3,10,6,4,3,3,5,13,38.5,8,9,1,8,15,25,8,0,Matches,2021
590,Leroy Sané,de GER,"FW,MF",Bayern Munich,24,1996,6.4,7,5,2,2,3,3,14,21.4,11,5,0,5,5,12,1,0,Matches,2021
591,Morgan Sanson,fr FRA,MF,Marseille,25,1994,4.1,9,6,3,4,2,2,11,18.2,9,6,0,6,5,14,0,0,Matches,2021
592,Douglas Santos,br BRA,DF,Zenit,26,1994,4.4,13,8,8,4,1,7,16,43.8,9,9,0,9,9,22,7,0,Matches,2021
593,Zaidu Sanusi,ng NGA,DF,Porto,23,1997,9.6,19,14,13,6,0,13,20,65.0,7,11,3,8,13,32,26,0,Matches,2021
594,Pablo Sarabia,es ESP,"FW,MF",Paris S-G,28,1992,1.6,3,3,1,2,0,0,3,0.0,3,2,1,1,2,5,1,0,Matches,2021
595,Bouna Sarr,sn SEN,DF,Bayern Munich,28,1992,2.1,1,1,0,1,0,0,2,0.0,2,3,0,3,2,3,5,0,Matches,2021
596,Malang Sarr,fr FRA,DF,Porto,21,1999,4.7,2,1,2,0,0,1,1,100.0,0,5,5,0,6,8,24,1,Matches,2021
597,Stefan Savić,me MNE,DF,Atlético Madrid,29,1991,7.9,6,3,2,3,1,2,4,50.0,2,7,5,2,8,14,40,0,Matches,2021
598,Alexander Scholz,dk DEN,DF,Midtjylland,27,1992,6.0,9,4,7,2,0,5,9,55.6,4,8,3,5,12,21,21,0,Matches,2021
599,Siebe Schrijvers,be BEL,"MF,FW",Club Brugge,24,1996,0.3,0,0,0,0,0,0,0,,0,1,0,1,1,1,0,0,Matches,2021
600,Nico Schulz,de GER,"DF,FW",Dortmund,27,1993,2.3,3,2,1,1,1,1,4,25.0,3,0,0,0,1,4,9,0,Matches,2021
601,Perr Schuurs,nl NED,DF,Ajax,20,1999,5.6,8,4,6,2,0,5,9,55.6,4,11,5,6,10,18,17,1,Matches,2021
602,Rúben Semedo,pt POR,DF,Olympiacos,26,1994,5.9,4,0,2,2,0,2,5,40.0,3,5,4,1,12,16,22,1,Matches,2021
603,Stefano Sensi,it ITA,MF,Inter,24,1995,0.1,0,0,0,0,0,0,1,0.0,1,0,0,0,0,0,0,0,Matches,2021
604,Artem Shabanov,ua UKR,DF,Dynamo Kyiv,28,1992,1.0,2,0,2,0,0,2,2,100.0,0,0,0,0,1,3,3,0,Matches,2021
605,Daniil Shamkin,ru RUS,MF,Zenit,18,2002,0.4,3,2,2,1,0,1,2,50.0,1,1,0,1,1,4,3,0,Matches,2021
606,Mykola Shaparenko,ua UKR,MF,Dynamo Kyiv,21,1998,4.7,14,9,6,6,2,4,13,30.8,9,5,1,4,6,20,4,0,Matches,2021
607,Xherdan Shaqiri,ch SUI,"MF,FW",Liverpool,28,1991,1.8,1,0,1,0,0,1,3,33.3,2,5,0,5,3,4,1,0,Matches,2021
608,Luke Shaw,eng ENG,DF,Manchester Utd,25,1995,3.7,7,5,2,4,1,4,4,100.0,0,3,0,3,8,15,6,0,Matches,2021
609,Volodymyr Shepelyev,ua UKR,MF,Dynamo Kyiv,23,1997,2.9,2,0,1,1,0,0,3,0.0,3,1,1,0,5,7,3,0,Matches,2021
610,Dávid Sigér,hu HUN,MF,Ferencváros,29,1990,4.3,3,0,0,2,1,1,4,25.0,3,3,1,2,5,8,2,1,Matches,2021
611,Bernardo Silva,pt POR,"MF,FW",Manchester City,25,1994,10.3,12,8,1,7,4,5,15,33.3,10,11,1,10,4,16,5,1,Matches,2021
612,Thiago Silva,br BRA,DF,Chelsea,35,1984,6.3,6,3,4,2,0,3,6,50.0,3,7,3,4,8,14,23,0,Matches,2021
613,Aleksandr Silyanov,ru RUS,MF,Loko Moscow,19,2001,0.0,1,0,1,0,0,1,1,100.0,0,0,0,0,0,1,1,0,Matches,2021
614,Pione Sisto,dk DEN,"MF,FW",Midtjylland,25,1995,3.8,3,2,1,1,1,0,7,0.0,7,3,1,2,1,4,0,0,Matches,2021
615,Milan Škriniar,sk SVK,DF,Inter,25,1995,3.0,6,3,5,1,0,2,5,40.0,3,3,2,1,2,8,4,0,Matches,2021
616,Martin Škrtel,sk SVK,DF,Başakşehir,35,1984,4.5,7,5,5,2,0,4,7,57.1,3,7,3,4,8,15,19,0,Matches,2021
617,Igor Smolnikov,ru RUS,"DF,MF",Krasnodar,31,1988,5.0,6,3,4,1,1,2,5,40.0,3,6,4,2,8,14,18,0,Matches,2021
618,Fyodor Smolov,ru RUS,"FW,MF",Loko Moscow,30,1990,2.2,1,0,0,1,0,0,0,,0,1,0,1,3,4,1,0,Matches,2021
619,Eduard Sobol,ua UKR,"DF,FW",Club Brugge,25,1995,3.5,5,5,1,3,1,3,3,100.0,0,1,0,1,2,7,5,0,Matches,2021
620,Manor Solomon,il ISR,"MF,FW",Shakhtar,21,1999,4.1,3,3,1,1,1,2,7,28.6,5,4,0,4,5,8,0,0,Matches,2021
621,Somália,br BRA,MF,Ferencváros,31,1988,5.2,7,3,4,2,1,3,6,50.0,3,3,0,3,11,18,2,0,Matches,2021
622,Yann Sommer,ch SUI,GK,M'Gladbach,31,1988,8.0,0,0,0,0,0,0,0,,0,0,0,0,0,0,2,0,Matches,2021
623,Brandon Soppy,fr FRA,DF,Rennes,18,2002,1.8,0,0,0,0,0,0,2,0.0,2,1,1,0,0,0,3,0,Matches,2021
624,Yegor Sorokin,ru RUS,DF,Krasnodar,24,1995,1.7,1,1,0,1,0,0,2,0.0,2,3,2,1,6,7,12,0,Matches,2021
625,Hillel Soudani,dz ALG,"FW,MF",Olympiacos,32,1987,0.4,0,0,0,0,0,0,0,,0,0,0,0,0,0,1,0,Matches,2021
626,Eduard Spertsyan,am ARM,"FW,MF",Krasnodar,20,2000,0.4,1,0,1,0,0,1,3,33.3,2,0,0,0,1,2,2,0,Matches,2021
627,Marco Sportiello,it ITA,GK,Atalanta,28,1992,5.0,0,0,0,0,0,0,1,0.0,1,0,0,0,0,0,0,2,Matches,2021
628,Cican Stankovic,at AUT,GK,RB Salzburg,27,1992,6.0,0,0,0,0,0,0,0,,0,1,0,1,0,0,0,1,Matches,2021
629,Zack Steffen,us USA,GK,Manchester City,25,1995,1.0,0,0,0,0,0,0,0,,0,0,0,0,0,0,0,0,Matches,2021
630,Taras Stepanenko,ua UKR,"MF,DF",Shakhtar,30,1989,3.2,2,2,0,1,1,2,4,50.0,2,3,1,2,5,7,11,0,Matches,2021
631,Raheem Sterling,eng ENG,FW,Manchester City,25,1994,7.2,6,2,0,3,3,0,3,0.0,3,3,0,3,3,9,0,0,Matches,2021
632,Angelo Stiller,de GER,"MF,FW",Bayern Munich,19,2001,0.2,1,1,1,0,0,1,1,100.0,0,0,0,0,1,2,0,0,Matches,2021
633,Lars Stindl,de GER,"MF,FW",M'Gladbach,31,1988,5.9,13,4,6,5,2,1,13,7.7,12,6,1,5,5,18,1,0,Matches,2021
634,John Stones,eng ENG,DF,Manchester City,26,1994,8.9,8,4,2,4,2,2,3,66.7,1,8,7,1,9,17,24,1,Matches,2021
635,Thomas Strakosha,al ALB,GK,Lazio,25,1995,1.0,0,0,0,0,0,0,0,,0,0,0,0,0,0,0,0,Matches,2021
636,Kevin Strootman,nl NED,MF,Marseille,30,1990,0.3,0,0,0,0,0,0,0,,0,1,0,1,1,1,0,0,Matches,2021
637,Luis Suárez,uy URU,FW,Atlético Madrid,33,1987,5.1,1,1,0,1,0,0,0,,0,3,2,1,1,2,5,0,Matches,2021
638,Luka Sučić,hr CRO,"MF,FW",RB Salzburg,17,2002,0.5,2,2,0,2,0,2,6,33.3,4,0,0,0,2,4,1,0,Matches,2021
639,Heorhii Sudakov,ua UKR,FW,Shakhtar,17,2002,0.1,0,0,0,0,0,0,1,0.0,1,0,0,0,0,0,0,0,Matches,2021
640,Niklas Süle,de GER,DF,Bayern Munich,24,1995,6.0,7,3,2,5,0,3,6,50.0,3,5,2,3,13,20,19,0,Matches,2021
641,Magomed-Shapi Suleymanov,ru RUS,"FW,MF",Krasnodar,20,1999,2.3,6,5,3,0,3,3,5,60.0,2,4,0,4,1,7,4,0,Matches,2021
642,Vladyslav Supriaha,ua UKR,FW,Dynamo Kyiv,20,2000,3.4,0,0,0,0,0,0,6,0.0,6,3,1,2,1,1,1,0,Matches,2021
643,Suso,es ESP,FW,Sevilla,26,1993,3.1,6,4,1,2,3,3,5,60.0,2,0,0,0,2,8,0,0,Matches,2021
644,Aleksei Sutormin,ru RUS,DF,Zenit,26,1994,2.7,6,4,4,1,1,4,11,36.4,7,3,1,2,2,8,4,0,Matches,2021
645,Erik Sviatchenko,dk DEN,DF,Midtjylland,28,1991,5.0,6,2,4,2,0,2,2,100.0,0,3,1,2,20,26,19,1,Matches,2021
646,Serhiy Sydorchuk,ua UKR,MF,Dynamo Kyiv,29,1991,3.9,4,3,2,1,1,2,5,40.0,3,5,1,4,12,16,7,1,Matches,2021
647,Wojciech Szczęsny,pl POL,GK,Juventus,30,1990,7.3,1,0,1,0,0,1,1,100.0,0,0,0,0,1,2,5,1,Matches,2021
648,Dominik Szoboszlai,hu HUN,"MF,FW",RB Salzburg,19,2000,5.6,4,1,2,0,2,1,8,12.5,7,6,1,5,3,7,10,0,Matches,2021
649,Alexander Sørloth,no NOR,"MF,FW",RB Leipzig,24,1995,1.3,1,0,0,1,0,1,1,100.0,0,0,0,0,0,1,0,0,Matches,2021
650,Dušan Tadić,rs SRB,"FW,MF",Ajax,31,1988,6.0,3,3,1,1,1,2,4,50.0,2,5,0,5,0,3,0,0,Matches,2021
651,Nicolás Tagliafico,ar ARG,DF,Ajax,27,1992,5.7,13,7,8,4,1,6,12,50.0,6,4,1,3,7,20,15,0,Matches,2021
652,Taison,br BRA,FW,Shakhtar,32,1988,3.1,4,3,4,0,0,0,4,0.0,4,5,0,5,0,4,3,0,Matches,2021
653,Flavien Tait,fr FRA,MF,Rennes,27,1993,0.5,0,0,0,0,0,0,0,,0,1,0,1,1,1,0,0,Matches,2021
654,Mehdi Taremi,ir IRN,FW,Porto,28,1992,2.2,0,0,0,0,0,0,2,0.0,2,3,1,2,2,2,2,0,Matches,2021
655,Mahmut Tekdemir,tr TUR,MF,Başakşehir,32,1988,2.0,4,1,1,3,0,1,4,25.0,3,2,1,1,6,10,2,0,Matches,2021
656,Alex Telles,br BRA,DF,Manchester Utd,27,1992,3.2,7,5,2,4,1,3,7,42.9,4,5,0,5,1,8,3,0,Matches,2021
657,Marc-André ter Stegen,de GER,GK,Barcelona,28,1992,5.0,0,0,0,0,0,0,0,,0,0,0,0,0,0,2,0,Matches,2021
658,Martin Terrier,fr FRA,"FW,MF",Rennes,23,1997,2.7,4,4,2,2,0,3,6,50.0,3,3,0,3,4,8,2,0,Matches,2021
659,Tetê,br BRA,"MF,FW",Shakhtar,20,2000,5.7,5,3,3,1,1,3,12,25.0,9,9,0,9,3,8,5,0,Matches,2021
660,Florian Thauvin,fr FRA,"FW,MF",Marseille,27,1993,5.3,8,6,6,1,1,5,12,41.7,7,2,0,2,2,10,2,0,Matches,2021
661,Marcus Thuram,fr FRA,FW,M'Gladbach,22,1997,6.6,5,3,3,2,0,2,10,20.0,8,14,2,12,6,11,6,0,Matches,2021
662,Steffen Tigges,de GER,FW,Dortmund,22,1998,0.1,0,0,0,0,0,0,1,0.0,1,0,0,0,0,0,0,0,Matches,2021
663,Jurriën Timber,nl NED,DF,Ajax,19,2001,0.0,0,0,0,0,0,0,0,,0,0,0,0,0,0,0,0,Matches,2021
664,Corentin Tolisso,fr FRA,MF,Bayern Munich,25,1994,2.8,1,0,0,1,0,0,2,0.0,2,3,0,3,1,2,2,0,Matches,2021
665,Rafael Tolói,it ITA,DF,Atalanta,29,1990,6.9,19,12,7,12,0,8,13,61.5,5,9,3,6,13,32,24,0,Matches,2021
666,Mehmet Topal,tr TUR,"MF,DF",Başakşehir,34,1986,2.5,4,1,3,1,0,3,4,75.0,1,3,1,2,7,11,7,0,Matches,2021
667,Lucas Torreira,uy URU,MF,Atlético Madrid,24,1996,0.5,3,2,0,3,0,1,3,33.3,2,0,0,0,2,5,1,0,Matches,2021
668,Ferrán Torres,es ESP,FW,Manchester City,20,2000,4.0,4,2,0,3,1,0,1,0.0,1,1,0,1,3,7,1,0,Matches,2021
669,Óliver Torres,es ESP,"MF,FW",Sevilla,25,1994,3.1,7,5,3,4,0,3,8,37.5,5,2,0,2,2,9,1,0,Matches,2021
670,Hamari Traoré,ml MLI,DF,Rennes,28,1992,6.0,6,4,5,1,0,4,9,44.4,5,6,1,5,11,17,12,0,Matches,2021
671,Ibrahima Traoré,gn GUI,FW,M'Gladbach,32,1988,0.3,1,0,1,0,0,0,1,0.0,1,0,0,0,0,1,0,0,Matches,2021
672,Francisco Trincão,pt POR,FW,Barcelona,20,1999,3.7,5,4,0,1,4,0,7,0.0,7,4,0,4,2,7,0,0,Matches,2021
673,Kieran Trippier,eng ENG,"DF,FW",Atlético Madrid,29,1990,6.8,11,5,5,4,2,6,10,60.0,4,8,2,6,10,21,14,0,Matches,2021
674,Anatolii Trubin,ua UKR,GK,Shakhtar,18,2001,5.0,0,0,0,0,0,0,2,0.0,2,0,0,0,1,1,2,1,Matches,2021
675,Adrien Truffert,fr FRA,DF,Rennes,18,2001,2.7,9,6,6,1,2,4,8,50.0,4,1,0,1,5,14,7,0,Matches,2021
676,Kostas Tsimikas,gr GRE,DF,Liverpool,24,1996,1.4,2,2,1,0,1,1,2,50.0,1,1,1,0,2,4,6,0,Matches,2021
677,Viktor Tsyhankov,ua UKR,"MF,FW",Dynamo Kyiv,22,1997,4.7,8,4,4,3,1,2,12,16.7,10,4,1,3,5,13,4,0,Matches,2021
678,Axel Tuanzebe,eng ENG,DF,Manchester Utd,22,1997,2.3,5,3,4,1,0,1,2,50.0,1,1,0,1,2,7,11,0,Matches,2021
679,Deniz Turuc,tr TUR,"MF,FW",Başakşehir,27,1993,5.8,1,1,1,0,0,1,7,14.3,6,6,4,2,5,6,3,0,Matches,2021
680,Andreas Ulmer,at AUT,DF,RB Salzburg,34,1985,6.0,18,12,10,7,1,7,14,50.0,7,7,1,6,11,29,8,0,Matches,2021
681,Samuel Umtiti,fr FRA,DF,Barcelona,26,1993,0.4,1,0,0,1,0,0,1,0.0,1,1,0,1,0,1,0,0,Matches,2021
682,Dayot Upamecano,fr FRA,DF,RB Leipzig,21,1998,6.7,22,16,15,7,0,11,15,73.3,4,6,2,4,14,36,13,2,Matches,2021
683,Mateus Uribe,co COL,MF,Porto,29,1991,8.3,20,14,11,8,1,5,12,41.7,7,7,0,7,8,28,12,0,Matches,2021
684,Daniil Utkin,ru RUS,"MF,FW",Krasnodar,20,1999,2.5,2,2,1,1,0,0,1,0.0,1,4,0,4,0,2,1,0,Matches,2021
685,Myrto Uzuni,al ALB,"MF,FW",Ferencváros,25,1995,2.7,1,1,0,1,0,0,3,0.0,3,2,0,2,2,3,1,0,Matches,2021
686,Tomáš Vaclík,cz CZE,GK,Sevilla,31,1989,2.0,0,0,0,0,0,0,1,0.0,1,0,0,0,0,0,0,0,Matches,2021
687,Mathieu Valbuena,fr FRA,"FW,MF",Olympiacos,35,1984,2.8,4,2,1,3,0,0,1,0.0,1,2,0,2,1,5,0,0,Matches,2021
688,Albert Vallci,at AUT,DF,RB Salzburg,25,1995,1.0,2,0,0,2,0,1,4,25.0,3,2,0,2,3,5,3,0,Matches,2021
689,Federico Valverde,uy URU,"MF,DF",Real Madrid,22,1998,5.4,13,8,5,2,6,6,12,50.0,6,10,1,9,17,30,4,0,Matches,2021
690,Thomas Van den Keybus,be BEL,DF,Club Brugge,19,2001,0.0,0,0,0,0,0,0,0,,0,0,0,0,0,0,0,0,Matches,2021
691,Ignace Van Der Brempt,be BEL,DF,Club Brugge,18,2002,0.1,0,0,0,0,0,0,0,,0,0,0,0,1,1,0,0,Matches,2021
692,Hans Vanaken,be BEL,MF,Club Brugge,27,1992,5.9,5,3,2,3,0,2,8,25.0,6,4,0,4,8,13,6,0,Matches,2021
693,Raphaël Varane,fr FRA,DF,Real Madrid,27,1993,9.0,11,4,8,2,1,2,4,50.0,2,5,3,2,14,25,32,1,Matches,2021
694,Franco Vázquez,ar ARG,"FW,MF",Sevilla,31,1989,1.0,3,2,0,3,0,2,4,50.0,2,1,1,0,1,4,0,0,Matches,2021
695,Lucas Vázquez,es ESP,"DF,FW",Real Madrid,29,1991,8.0,16,12,6,8,2,9,23,39.1,14,10,0,10,6,22,9,0,Matches,2021
696,Benjamin Verbič,si SVN,FW,Dynamo Kyiv,26,1993,3.2,4,2,0,3,1,1,7,14.3,6,6,0,6,2,6,1,0,Matches,2021
697,Marco Verratti,it ITA,"MF,FW",Paris S-G,27,1992,5.6,21,10,8,10,3,11,23,47.8,12,4,1,3,6,27,2,0,Matches,2021
698,Lasse Vibe,dk DEN,"FW,MF",Midtjylland,33,1987,0.5,1,1,0,1,0,0,0,,0,0,0,0,0,1,0,0,Matches,2021
699,Arturo Vidal,cl CHI,MF,Inter,33,1987,3.2,12,8,2,9,1,4,11,36.4,7,5,0,5,6,18,3,1,Matches,2021
700,Fabio Vieira,pt POR,MF,Porto,20,2000,1.8,5,2,4,0,1,2,3,66.7,1,1,0,1,1,6,1,0,Matches,2021
701,Tonny Vilhena,nl NED,MF,Krasnodar,25,1995,4.3,9,3,4,5,0,5,17,29.4,12,3,0,3,6,15,8,0,Matches,2021
702,Rúben Vinagre,pt POR,"DF,FW",Olympiacos,21,1999,0.2,1,0,0,1,0,0,0,,0,0,0,0,0,1,1,0,Matches,2021
703,Edin Višća,ba BIH,MF,Başakşehir,30,1990,4.7,4,2,0,2,2,2,5,40.0,3,5,0,5,3,7,2,0,Matches,2021
704,Vitão,br BRA,DF,Shakhtar,20,2000,1.4,3,2,3,0,0,3,4,75.0,1,2,2,0,5,8,11,0,Matches,2021
705,Vitolo,es ESP,"MF,DF",Atlético Madrid,30,1989,0.3,2,0,0,1,1,1,1,100.0,0,1,0,1,0,2,0,0,Matches,2021
706,Bohdan Viunnyk,ua UKR,MF,Shakhtar,18,2002,0.0,0,0,0,0,0,0,0,,0,0,0,0,0,0,0,0,Matches,2021
707,Ruud Vormer,nl NED,MF,Club Brugge,32,1988,5.7,11,10,2,6,3,4,7,57.1,3,1,0,1,8,19,1,1,Matches,2021
708,Stefan de Vrij,nl NED,DF,Inter,28,1992,6.0,6,5,2,4,0,3,4,75.0,1,8,4,4,17,23,16,0,Matches,2021
709,Marious Vrousai,gr GRE,"FW,DF",Olympiacos,22,1998,2.1,6,2,3,2,1,1,2,50.0,1,2,0,2,5,11,2,0,Matches,2021
710,Kyle Walker,eng ENG,DF,Manchester City,30,1990,10.9,23,12,8,9,6,10,14,71.4,4,6,1,5,14,37,17,0,Matches,2021
711,Aaron Wan-Bissaka,eng ENG,DF,Manchester Utd,22,1997,5.2,14,6,9,4,1,9,12,75.0,3,10,2,8,9,23,15,0,Matches,2021
712,Wanderson,br BRA,"FW,MF",Krasnodar,25,1994,2.3,3,1,1,1,1,1,2,50.0,1,1,0,1,2,5,0,0,Matches,2021
713,Wendel,br BRA,"MF,FW",Zenit,22,1997,1.6,4,3,2,2,0,3,8,37.5,5,1,0,1,2,6,1,0,Matches,2021
714,Oscar Wendt,se SWE,DF,M'Gladbach,34,1985,2.4,7,5,4,2,1,3,6,50.0,3,5,3,2,6,13,4,0,Matches,2021
715,Timo Werner,de GER,FW,Chelsea,24,1996,9.0,6,4,2,4,0,2,13,15.4,11,9,0,9,6,12,3,0,Matches,2021
716,Georginio Wijnaldum,nl NED,MF,Liverpool,29,1990,8.0,7,2,2,5,0,0,4,0.0,4,4,0,4,9,16,2,0,Matches,2021
717,Brandon Williams,eng ENG,DF,Manchester Utd,19,2000,0.7,1,0,0,1,0,0,0,,0,1,0,1,1,2,2,0,Matches,2021
718,Neco Williams,wls WAL,DF,Liverpool,19,2001,2.1,7,4,4,3,0,2,3,66.7,1,4,1,3,6,13,3,1,Matches,2021
719,Rhys Williams,eng ENG,DF,Liverpool,19,2001,3.7,4,3,2,2,0,2,5,40.0,3,0,0,0,5,9,13,0,Matches,2021
720,Axel Witsel,be BEL,"MF,DF",Dortmund,31,1989,4.0,8,6,2,3,3,1,5,20.0,4,1,1,0,7,15,5,0,Matches,2021
721,Maximilian Wöber,at AUT,DF,RB Salzburg,22,1998,5.7,10,7,9,1,0,3,11,27.3,8,5,4,1,11,21,31,0,Matches,2021
722,Hannes Wolf,at AUT,"MF,FW",M'Gladbach,21,1999,0.9,1,1,1,0,0,0,2,0.0,2,2,0,2,0,1,1,0,Matches,2021
723,Ashley Young,eng ENG,DF,Inter,35,1985,4.6,4,3,2,2,0,2,4,50.0,2,1,0,1,3,7,6,0,Matches,2021
724,Illia Zabarnyi,ua UKR,DF,Dynamo Kyiv,17,2002,6.0,2,1,2,0,0,2,7,28.6,5,6,5,1,8,10,34,0,Matches,2021
725,Dan-Axel Zagadou,fr FRA,DF,Dortmund,21,1999,0.2,1,0,1,0,0,0,0,,0,1,1,0,1,2,7,0,Matches,2021
726,Denis Zakaria,ch SUI,"MF,DF",M'Gladbach,23,1996,3.2,10,7,8,2,0,4,7,57.1,3,2,1,1,3,13,4,0,Matches,2021
727,Duván Zapata,co COL,FW,Atalanta,29,1991,5.8,4,3,2,2,0,1,1,100.0,0,2,0,2,1,5,10,0,Matches,2021
728,Rifat Zhemaletdinov,ru RUS,"MF,FW",Loko Moscow,23,1996,1.2,2,0,2,0,0,2,2,100.0,0,2,0,2,0,2,3,0,Matches,2021
729,Yuri Zhirkov,ru RUS,"MF,DF",Zenit,36,1983,1.8,2,2,0,1,1,2,3,66.7,1,2,1,1,2,4,3,0,Matches,2021
730,Dmitri Zhivoglyadov,ru RUS,DF,Loko Moscow,26,1994,5.9,9,6,7,1,1,5,8,62.5,3,7,3,4,8,17,20,0,Matches,2021
731,Oleksandr Zinchenko,ua UKR,DF,Manchester City,23,1996,6.5,12,7,7,5,0,7,12,58.3,5,7,1,6,4,16,12,0,Matches,2021
732,Joshua Zirkzee,nl NED,FW,Bayern Munich,19,2001,0.1,0,0,0,0,0,0,1,0.0,1,0,0,0,0,0,0,0,Matches,2021
733,Hakim Ziyech,ma MAR,"FW,MF",Chelsea,27,1993,3.9,9,6,2,3,4,3,11,27.3,8,2,0,2,4,13,2,0,Matches,2021
734,Kurt Zouma,fr FRA,DF,Chelsea,25,1994,5.0,3,2,1,2,0,2,4,50.0,2,5,5,0,2,5,23,0,Matches,2021
735,Oleksandr Zubkov,ua UKR,"FW,MF",Ferencváros,23,1996,4.3,5,5,1,2,2,2,7,28.6,5,3,1,2,4,9,4,0,Matches,2021
736,Martin Ødegaard,no NOR,MF,Real Madrid,21,1998,1.5,2,1,0,1,1,2,4,50.0,2,0,0,0,0,2,1,0,Matches,2021
1,Tammy Abraham,eng ENG,FW,Chelsea,21,1997,6.3,5,2,0,4,1,1,4,25.0,3,7,2,5,1,6,10,0,Matches,2020
2,Tyler Adams,us USA,"MF,DF",RB Leipzig,20,1999,0.9,1,0,1,0,0,0,1,0.0,1,1,1,0,0,1,2,0,Matches,2020
3,Arijan Ademi,mk MKD,"MF,DF",Dinamo Zagreb,28,1991,5.7,8,2,4,4,0,2,9,22.2,7,4,0,4,2,10,12,0,Matches,2020
4,Adrián,es ESP,GK,Liverpool,32,1987,3.3,0,0,0,0,0,0,0,,0,0,0,0,0,0,0,1,Matches,2020
5,Sergio Agüero,ar ARG,FW,Manchester City,31,1988,2.2,0,0,0,0,0,0,1,0.0,1,1,0,1,0,0,1,0,Matches,2020
6,Manuel Akanji,ch SUI,DF,Dortmund,24,1995,5.8,11,7,8,2,1,5,10,50.0,5,7,4,3,9,20,9,0,Matches,2020
7,David Alaba,at AUT,DF,Bayern Munich,27,1992,7.5,7,6,6,1,0,4,5,80.0,1,5,3,2,6,13,17,3,Matches,2020
8,Lucas Alario,ar ARG,FW,Leverkusen,26,1992,2.4,2,1,1,1,0,0,1,0.0,1,0,0,0,3,5,1,0,Matches,2020
9,Jordi Alba,es ESP,DF,Barcelona,30,1989,3.9,1,1,0,1,0,0,3,0.0,3,5,3,2,7,8,9,0,Matches,2020
10,Paco Alcácer,es ESP,FW,Dortmund,25,1993,1.3,1,1,0,0,1,0,1,0.0,1,0,0,0,4,5,2,0,Matches,2020
11,Thiago Alcántara,es ESP,MF,Bayern Munich,28,1991,9.1,34,23,10,21,3,11,23,47.8,12,6,0,6,23,57,4,0,Matches,2020
12,Toby Alderweireld,be BEL,DF,Tottenham,30,1989,6.0,7,3,5,2,0,4,6,66.7,2,7,3,4,3,10,34,0,Matches,2020
13,Carles Aleñá,es ESP,MF,Barcelona,21,1998,1.0,1,0,1,0,0,1,5,20.0,4,1,0,1,1,2,0,0,Matches,2020
14,Trent Alexander-Arnold,eng ENG,DF,Liverpool,20,1998,6.5,16,11,7,8,1,9,14,64.3,5,2,1,1,7,23,6,0,Matches,2020
15,Alisson,br BRA,GK,Liverpool,26,1992,5.0,0,0,0,0,0,0,0,,0,0,0,0,0,0,3,0,Matches,2020
16,Allan,br BRA,MF,Napoli,28,1991,4.9,23,15,13,8,2,16,30,53.3,14,14,2,12,4,27,11,1,Matches,2020
17,Dele Alli,eng ENG,"MF,FW",Tottenham,23,1996,5.7,6,4,3,2,1,3,9,33.3,6,5,2,3,5,11,1,0,Matches,2020
18,André Almeida,pt POR,DF,Benfica,28,1990,1.0,2,1,2,0,0,2,2,100.0,0,2,1,1,1,3,5,0,Matches,2020
19,Marcos Alonso,es ESP,DF,Chelsea,28,1990,4.4,5,4,4,1,0,1,3,33.3,2,1,0,1,6,11,14,0,Matches,2020
20,Éder Álvarez Balanta,co COL,MF,Club Brugge,26,1993,3.2,9,5,1,4,4,3,12,25.0,9,6,1,5,6,15,2,0,Matches,2020
21,Edson Álvarez,mx MEX,MF,Ajax,21,1997,4.2,14,9,7,4,3,8,16,50.0,8,6,4,2,5,19,7,0,Matches,2020
22,Nadiem Amiri,de GER,"FW,MF",Leverkusen,22,1996,2.6,8,5,4,3,1,1,5,20.0,4,2,0,2,1,9,1,0,Matches,2020
23,Ethan Ampadu,wls WAL,DF,RB Leipzig,18,2000,2.0,4,1,4,0,0,2,4,50.0,2,3,2,1,4,8,10,0,Matches,2020
24,Joachim Andersen,dk DEN,DF,Lyon,23,1996,4.4,3,2,2,1,0,1,3,33.3,2,6,4,2,7,10,36,0,Matches,2020
25,Florin Andone,ro ROU,FW,Galatasaray,26,1993,1.8,1,1,0,1,0,1,2,50.0,1,3,0,3,0,1,1,0,Matches,2020
26,Benjamin André,fr FRA,MF,Lille,28,1990,4.5,18,12,8,8,2,3,18,16.7,15,7,3,4,11,29,6,0,Matches,2020
27,Miguel Ángel Guerrero,es ESP,FW,Olympiacos,29,1990,3.5,3,1,0,3,0,0,1,0.0,1,1,1,0,0,3,4,0,Matches,2020
28,Angeliño,es ESP,"DF,MF",RB Leipzig,22,1997,4.0,2,2,1,1,0,0,2,0.0,2,3,0,3,5,7,8,0,Matches,2020
29,Angeliño,es ESP,DF,Manchester City,22,1997,1.0,3,2,3,0,0,1,2,50.0,1,0,0,0,1,4,1,0,Matches,2020
30,Marcos Antônio,br BRA,MF,Shakhtar,19,2000,0.3,1,1,0,1,0,0,0,,0,0,0,0,2,3,0,0,Matches,2020
31,Houssem Aouar,dz ALG,"MF,FW",Lyon,21,1998,7.9,14,6,4,8,2,5,19,26.3,14,12,2,10,5,19,2,0,Matches,2020
32,Youssef El-Arabi,ma MAR,FW,Olympiacos,32,1987,3.1,1,1,0,0,1,1,4,25.0,3,2,0,2,0,1,1,0,Matches,2020
33,Charles Aránguiz,cl CHI,MF,Leverkusen,30,1989,4.6,5,0,1,4,0,2,12,16.7,10,6,1,5,1,6,7,0,Matches,2020
34,Luiz Araújo,br BRA,"FW,MF",Lille,23,1996,3.1,4,2,0,1,3,0,7,0.0,7,3,1,2,5,9,0,0,Matches,2020
35,Alphonse Areola,fr FRA,GK,Real Madrid,26,1993,1.5,0,0,0,0,0,0,0,,0,0,0,0,0,0,0,0,Matches,2020
36,Santiago Arias,co COL,DF,Atlético Madrid,27,1992,2.0,5,4,5,0,0,2,2,100.0,0,0,0,0,3,8,4,0,Matches,2020
37,Kepa Arrizabalaga,es ESP,GK,Chelsea,24,1994,6.0,1,0,1,0,0,1,1,100.0,0,0,0,0,0,1,3,0,Matches,2020
38,Kwadwo Asamoah,gh GHA,"FW,DF",Inter,30,1988,2.9,3,1,1,1,1,1,4,25.0,3,5,0,5,1,4,2,0,Matches,2020
39,Marco Asensio,es ESP,FW,Real Madrid,23,1996,0.3,0,0,0,0,0,0,0,,0,0,0,0,0,0,0,0,Matches,2020
40,Majeed Ashimeru,gh GHA,MF,RB Salzburg,21,1997,0.7,3,1,1,1,1,1,5,20.0,4,0,0,0,0,3,0,0,Matches,2020
41,Iyayi Atiemwen,ng NGA,FW,Dinamo Zagreb,23,1996,0.1,0,0,0,0,0,0,0,,0,0,0,0,0,0,0,0,Matches,2020
42,Serge Aurier,ci CIV,DF,Tottenham,26,1992,5.0,8,7,2,4,2,4,9,44.4,5,7,3,4,2,10,9,0,Matches,2020
43,Sardar Azmoun,ir IRN,FW,Zenit,24,1995,5.1,3,1,1,2,0,0,6,0.0,6,2,2,0,3,6,5,0,Matches,2020
44,César Azpilicueta,es ESP,DF,Chelsea,29,1989,6.8,13,5,6,3,4,7,11,63.6,4,10,2,8,11,24,15,0,Matches,2020
45,Ryan Babel,nl NED,FW,Galatasaray,32,1986,3.7,2,1,0,2,0,0,3,0.0,3,2,0,2,0,2,4,0,Matches,2020
46,Leon Bailey,jm JAM,"FW,MF",Leverkusen,21,1997,1.3,1,0,0,0,1,0,1,0.0,1,3,0,3,0,1,1,1,Matches,2020
47,Gareth Bale,wls WAL,"FW,MF",Real Madrid,30,1989,1.3,0,0,0,0,0,0,1,0.0,1,1,0,1,4,4,1,0,Matches,2020
48,Leonardo Balerdi,ar ARG,MF,Dortmund,20,1999,0.1,0,0,0,0,0,0,0,,0,1,0,1,0,0,0,0,Matches,2020
49,Jonathan Bamba,ci CIV,"FW,MF",Lille,23,1996,3.1,4,3,2,2,0,2,5,40.0,3,2,0,2,3,7,2,0,Matches,2020
50,Nicolò Barella,it ITA,MF,Inter,22,1997,3.2,11,6,3,6,2,2,9,22.2,7,3,0,3,7,18,4,0,Matches,2020
51,Dmitri Barinov,ru RUS,MF,Loko Moscow,22,1996,5.0,8,3,3,4,1,4,16,25.0,12,6,3,3,5,13,7,0,Matches,2020
52,Ross Barkley,eng ENG,"FW,MF",Chelsea,25,1993,1.8,0,0,0,0,0,0,1,0.0,1,0,0,0,1,1,1,1,Matches,2020
53,Wílmar Barrios,co COL,MF,Zenit,25,1993,6.0,20,12,12,8,0,6,22,27.3,16,8,5,3,23,43,2,0,Matches,2020
54,Musa Barrow,gm GAM,MF,Atalanta,20,1998,0.0,0,0,0,0,0,0,1,0.0,1,0,0,0,0,0,0,0,Matches,2020
55,Michy Batshuayi,be BEL,FW,Chelsea,25,1993,1.0,0,0,0,0,0,0,0,,0,0,0,0,0,0,1,0,Matches,2020
56,Julian Baumgartlinger,at AUT,MF,Leverkusen,31,1988,3.8,11,10,6,3,2,6,14,42.9,8,0,0,0,4,15,4,1,Matches,2020
57,Ömer Bayram,tr TUR,"FW,MF",Galatasaray,28,1991,2.8,5,1,5,0,0,1,2,50.0,1,3,0,3,2,7,1,0,Matches,2020
58,Donny van de Beek,nl NED,MF,Ajax,22,1997,5.0,11,3,1,6,4,5,14,35.7,9,7,0,7,10,21,2,0,Matches,2020
59,Younès Belhanda,ma MAR,"MF,FW",Galatasaray,29,1990,3.4,6,3,3,3,0,3,4,75.0,1,3,0,3,3,9,0,0,Matches,2020
60,Karim Bellarabi,de GER,"FW,MF",Leverkusen,29,1990,4.6,3,2,0,3,0,2,10,20.0,8,6,1,5,2,5,1,0,Matches,2020
61,Lars Bender,de GER,DF,Leverkusen,30,1989,3.0,7,6,4,3,0,3,7,42.9,4,4,0,4,5,12,5,0,Matches,2020
62,Sven Bender,de GER,DF,Leverkusen,30,1989,6.0,14,6,11,2,1,5,11,45.5,6,8,1,7,19,33,18,0,Matches,2020
63,Rodrigo Bentancur,uy URU,MF,Juventus,22,1997,4.7,17,14,5,8,4,6,13,46.2,7,6,1,5,6,23,3,0,Matches,2020
64,Karim Benzema,fr FRA,FW,Real Madrid,31,1987,7.2,4,3,1,3,0,1,2,50.0,1,6,0,6,2,6,4,0,Matches,2020
65,Yassine Benzia,dz ALG,MF,Olympiacos,24,1994,0.9,9,6,2,6,1,5,8,62.5,3,0,0,0,0,9,2,0,Matches,2020
66,Sander Berge,no NOR,MF,Genk,21,1998,6.0,9,7,5,4,0,5,11,45.5,6,7,4,3,7,16,14,1,Matches,2020
67,Steven Bergwijn,nl NED,"MF,FW",Tottenham,21,1997,1.0,1,1,1,0,0,1,1,100.0,0,0,0,0,0,1,0,0,Matches,2020
68,Federico Bernardeschi,it ITA,MF,Juventus,25,1994,2.9,1,1,0,1,0,0,2,0.0,2,3,0,3,0,1,2,0,Matches,2020
69,Juan Bernat,es ESP,DF,Paris S-G,26,1993,9.7,17,11,12,1,4,8,21,38.1,13,10,1,9,12,29,25,0,Matches,2020
70,Antoine Bernede,fr FRA,MF,RB Salzburg,20,1999,1.0,3,1,1,2,0,2,4,50.0,2,0,0,0,2,5,0,0,Matches,2020
71,Cristiano Biraghi,it ITA,"DF,FW",Inter,26,1992,2.4,4,1,1,1,2,1,3,33.3,2,6,2,4,2,6,5,0,Matches,2020
72,Daley Blind,nl NED,DF,Ajax,29,1990,4.7,9,6,4,3,2,2,5,40.0,3,3,3,0,4,13,13,0,Matches,2020
73,Richmond Boakye,gh GHA,FW,Red Star,26,1993,2.1,1,0,1,0,0,1,1,100.0,0,1,0,1,0,1,5,0,Matches,2020
74,Jérôme Boateng,de GER,DF,Bayern Munich,30,1988,6.4,6,4,4,2,0,5,8,62.5,3,3,1,2,9,15,9,0,Matches,2020
75,Serhiy Bolbat,ua UKR,DF,Shakhtar,26,1993,2.7,7,3,3,2,2,1,5,20.0,4,3,2,1,4,11,8,0,Matches,2020
76,Theo Bongonda,cd COD,"MF,FW",Genk,23,1995,2.9,5,1,1,4,0,1,4,25.0,3,1,0,1,0,5,3,0,Matches,2020
77,Leonardo Bonucci,it ITA,DF,Juventus,32,1987,7.0,5,3,3,1,1,2,3,66.7,1,7,4,3,9,14,27,0,Matches,2020
78,Neto Borges,br BRA,DF,Genk,22,1996,0.1,0,0,0,0,0,0,0,,0,0,0,0,0,0,0,0,Matches,2020
79,Jan Bořil,cz CZE,DF,Slavia Prague,28,1991,6.0,5,2,3,1,1,4,16,25.0,12,4,1,3,7,12,8,0,Matches,2020
80,Milan Borjan,ca CAN,GK,Red Star,31,1987,6.0,0,0,0,0,0,0,0,,0,0,0,0,0,0,3,1,Matches,2020
81,Andreas Bouchalakis,gr GRE,MF,Olympiacos,26,1993,5.3,5,3,0,4,1,1,7,14.3,6,5,4,1,9,14,6,0,Matches,2020
82,Domagoj Bradarić,hr CRO,"MF,DF",Lille,19,1999,3.0,4,3,2,1,1,0,8,0.0,8,5,1,4,1,5,4,0,Matches,2020
83,Julian Brandt,de GER,"MF,FW",Dortmund,23,1996,5.4,6,1,4,2,0,2,13,15.4,11,7,1,6,2,8,2,0,Matches,2020
84,Claudio Bravo,cl CHI,GK,Manchester City,36,1983,1.4,0,0,0,0,0,0,0,,0,0,0,0,0,0,1,0,Matches,2020
85,Marcelo Brozović,hr CRO,MF,Inter,26,1992,5.8,16,8,8,7,1,6,18,33.3,12,8,1,7,10,26,12,0,Matches,2020
86,Jacob Bruun Larsen,dk DEN,FW,Dortmund,20,1998,0.2,0,0,0,0,0,0,0,,0,0,0,0,0,0,0,0,Matches,2020
87,Gianluigi Buffon,it ITA,GK,Juventus,41,1978,1.0,0,0,0,0,0,0,0,,0,0,0,0,0,0,1,0,Matches,2020
88,Mick van Buren,nl NED,FW,Slavia Prague,26,1992,0.5,1,1,0,0,1,0,0,,0,2,0,2,0,1,0,0,Matches,2020
89,Roman Bürki,ch SUI,GK,Dortmund,28,1990,8.0,0,0,0,0,0,0,0,,0,1,0,1,0,0,4,1,Matches,2020
90,Sergio Busquets,es ESP,MF,Barcelona,31,1988,5.6,8,6,2,5,1,6,15,40.0,9,7,1,6,15,23,6,1,Matches,2020
91,Adem Büyük,tr TUR,FW,Galatasaray,31,1987,1.0,0,0,0,0,0,0,2,0.0,2,0,0,0,0,0,1,0,Matches,2020
92,Willy Caballero,ar ARG,GK,Chelsea,37,1981,2.0,0,0,0,0,0,0,0,,0,0,0,0,0,0,1,1,Matches,2020
93,Mattia Caldara,it ITA,DF,Atalanta,25,1994,2.8,2,1,1,1,0,1,9,11.1,8,1,1,0,5,7,11,0,Matches,2020
94,José Callejón,es ESP,"MF,FW",Napoli,32,1987,6.3,6,4,2,3,1,4,9,44.4,5,4,0,4,4,10,5,0,Matches,2020
95,Mohamed Camara,gn GUI,MF,Olympiacos,22,1997,4.6,8,5,4,3,1,5,11,45.5,6,5,2,3,5,13,4,0,Matches,2020
96,Emre Can,de GER,MF,Dortmund,25,1994,2.0,1,1,0,1,0,1,5,20.0,4,2,0,2,1,2,1,0,Matches,2020
97,José Cañas,es ESP,MF,Red Star,32,1987,3.5,4,2,2,2,0,3,15,20.0,12,3,0,3,4,8,3,1,Matches,2020
98,João Cancelo,pt POR,DF,Manchester City,25,1994,6.3,17,14,7,5,5,10,17,58.8,7,4,0,4,13,30,5,0,Matches,2020
99,Antonio Candreva,it ITA,"FW,DF",Inter,32,1987,4.3,3,3,3,0,0,3,6,50.0,3,6,1,5,4,7,7,0,Matches,2020
100,Maxence Caqueret,fr FRA,MF,Lyon,19,2000,3.0,7,3,3,3,1,2,10,20.0,8,10,2,8,6,13,4,0,Matches,2020
101,Yannick Carrasco,be BEL,"MF,FW",Atlético Madrid,25,1993,1.0,1,1,0,1,0,0,4,0.0,4,3,0,3,0,1,0,0,Matches,2020
102,Dani Carvajal,es ESP,DF,Real Madrid,27,1992,6.9,15,10,7,6,2,9,18,50.0,9,14,7,7,6,21,15,0,Matches,2020
103,Casemiro,br BRA,MF,Real Madrid,27,1992,7.7,23,12,13,10,0,9,21,42.9,12,7,1,6,8,31,9,0,Matches,2020
104,Timothy Castagne,be BEL,DF,Atalanta,23,1995,4.4,3,1,0,3,0,2,7,28.6,5,10,2,8,1,4,5,0,Matches,2020
105,Edinson Cavani,uy URU,FW,Paris S-G,32,1987,1.5,2,1,0,1,1,0,2,0.0,2,2,0,2,0,2,0,0,Matches,2020
106,Zeki Çelik,tr TUR,"DF,MF",Lille,22,1997,6.0,11,6,6,3,2,3,11,27.3,8,8,0,8,11,22,18,3,Matches,2020
107,Murilo Cerqueira,br BRA,"MF,DF",Loko Moscow,22,1997,4.1,7,6,3,2,2,3,16,18.8,13,7,5,2,15,22,12,0,Matches,2020
108,Franco Cervi,ar ARG,MF,Benfica,25,1994,4.4,17,12,4,11,2,6,14,42.9,8,9,2,7,3,20,2,0,Matches,2020
109,Rayan Cherki,fr FRA,"DF,MF",Lyon,15,2003,0.4,2,0,1,1,0,2,3,66.7,1,0,0,0,0,2,0,0,Matches,2020
110,Denis Cheryshev,ru RUS,"MF,FW",Valencia,28,1990,2.9,3,1,0,2,1,1,9,11.1,8,2,0,2,1,4,1,0,Matches,2020
111,Chiquinho,pt POR,FW,Benfica,24,1995,3.0,3,3,2,1,0,1,8,12.5,7,1,0,1,3,6,1,0,Matches,2020
112,Andreas Christensen,dk DEN,DF,Chelsea,23,1996,4.0,3,1,2,1,0,1,3,33.3,2,1,0,1,3,6,18,1,Matches,2020
113,Jasper Cillessen,nl NED,GK,Valencia,30,1989,6.0,0,0,0,0,0,0,0,,0,0,0,0,1,1,2,0,Matches,2020
114,Kingsley Coman,fr FRA,FW,Bayern Munich,23,1996,6.1,7,2,2,2,3,2,11,18.2,9,8,0,8,0,7,1,0,Matches,2020
115,Dion Cools,my MAS,MF,Club Brugge,23,1996,0.0,0,0,0,0,0,0,0,,0,0,0,0,0,0,0,0,Matches,2020
116,Francis Coquelin,fr FRA,"MF,DF",Valencia,28,1991,4.8,9,7,5,2,2,3,5,60.0,2,1,1,0,11,20,12,0,Matches,2020
117,Vedran Ćorluka,hr CRO,DF,Loko Moscow,33,1986,5.8,7,5,5,2,0,3,4,75.0,1,7,6,1,12,19,43,0,Matches,2020
118,Maxwel Cornet,ci CIV,"DF,MF",Lyon,22,1996,6.1,8,6,3,3,2,5,13,38.5,8,5,2,3,8,16,8,0,Matches,2020
119,Carlos Coronel,py PAR,GK,RB Salzburg,22,1996,2.6,0,0,0,0,0,0,0,,0,0,0,0,0,0,1,1,Matches,2020
120,Ángel Correa,ar ARG,"MF,FW",Atlético Madrid,24,1995,4.9,11,3,4,4,3,5,14,35.7,9,5,1,4,5,16,4,0,Matches,2020
121,Thierry Correia,pt POR,DF,Valencia,20,1999,0.2,0,0,0,0,0,0,0,,0,0,0,0,1,1,1,0,Matches,2020
122,Diego Costa,es ESP,FW,Atlético Madrid,30,1988,5.1,0,0,0,0,0,0,2,0.0,2,2,0,2,0,0,8,0,Matches,2020
123,Douglas Costa,br BRA,MF,Juventus,28,1990,0.2,0,0,0,0,0,0,0,,0,0,0,0,0,0,0,0,Matches,2020
124,Jaume Costa,es ESP,DF,Valencia,31,1988,2.7,6,4,3,3,0,4,9,44.4,5,5,1,4,5,11,7,0,Matches,2020
125,Gaëtan Coucke,be BEL,GK,Genk,20,1998,5.0,0,0,0,0,0,0,0,,0,0,0,0,0,0,3,1,Matches,2020
126,Vladimír Coufal,cz CZE,DF,Slavia Prague,26,1992,6.0,11,4,5,5,1,5,9,55.6,4,6,3,3,6,17,12,0,Matches,2020
127,Thibaut Courtois,be BEL,GK,Real Madrid,27,1992,6.5,0,0,0,0,0,0,0,,0,0,0,0,1,1,8,1,Matches,2020
128,Philippe Coutinho,br BRA,"MF,FW",Bayern Munich,27,1992,5.8,6,3,0,1,5,2,12,16.7,10,6,0,6,1,7,0,0,Matches,2020
129,Juan Cuadrado,co COL,"DF,FW",Juventus,31,1988,5.5,8,3,5,2,1,1,11,9.1,10,5,0,5,11,19,10,0,Matches,2020
130,Carlos Cuesta,co COL,"DF,MF",Genk,20,1999,4.0,9,4,4,4,1,5,8,62.5,3,12,9,3,7,16,15,0,Matches,2020
131,Matheus Cunha,br BRA,FW,RB Leipzig,20,1999,0.9,2,2,0,0,2,0,3,0.0,3,0,0,0,3,5,0,0,Matches,2020
132,Danilo D'Ambrosio,it ITA,"DF,FW",Inter,30,1988,2.0,6,3,2,4,0,2,6,33.3,4,0,0,0,4,10,1,0,Matches,2020
133,Jacopo Da Riva,it ITA,MF,Atalanta,18,2000,0.1,0,0,0,0,0,0,1,0.0,1,0,0,0,1,1,0,0,Matches,2020
134,Colin Dagba,fr FRA,DF,Paris S-G,20,1998,1.0,0,0,0,0,0,0,2,0.0,2,1,0,1,2,2,0,0,Matches,2020
135,Mahmoud Dahoud,de GER,MF,Dortmund,23,1996,0.3,0,0,0,0,0,0,1,0.0,1,1,0,1,1,1,0,0,Matches,2020
136,Patson Daka,zm ZAM,FW,RB Salzburg,20,1998,2.7,4,4,0,1,3,1,3,33.3,2,4,0,4,1,5,1,0,Matches,2020
137,Danilo,br BRA,DF,Juventus,28,1991,5.2,13,5,6,5,2,6,7,85.7,1,1,1,0,8,21,14,0,Matches,2020
138,Alphonso Davies,ca CAN,DF,Bayern Munich,18,2000,7.9,18,12,8,8,2,12,21,57.1,9,7,0,7,10,28,11,0,Matches,2020
139,Ben Davies,wls WAL,DF,Tottenham,26,1993,3.0,3,1,2,1,0,2,2,100.0,0,2,2,0,2,5,6,0,Matches,2020
140,Kevin De Bruyne,be BEL,"MF,FW",Manchester City,28,1991,6.3,8,5,1,4,3,5,17,29.4,12,6,0,6,6,14,5,0,Matches,2020
141,Charles De Ketelaere,be BEL,"MF,FW",Club Brugge,18,2001,1.4,4,3,0,4,0,2,3,66.7,1,0,0,0,1,5,0,0,Matches,2020
142,Mattia De Sciglio,it ITA,DF,Juventus,26,1992,2.0,3,3,0,3,0,3,5,60.0,2,3,0,3,1,4,9,0,Matches,2020
143,Miloš Degenek,au AUS,DF,Red Star,25,1994,6.0,11,6,10,1,0,7,11,63.6,4,12,6,6,13,24,33,0,Matches,2020
144,Thomas Delaney,dk DEN,MF,Dortmund,27,1991,2.7,7,2,7,0,0,3,4,75.0,1,6,1,5,4,11,7,0,Matches,2020
145,Simon Deli,ci CIV,DF,Club Brugge,27,1991,6.0,7,3,5,2,0,1,3,33.3,2,4,3,1,12,19,24,0,Matches,2020
146,Moussa Dembélé,fr FRA,FW,Lyon,23,1996,6.9,3,1,0,2,1,0,3,0.0,3,9,4,5,4,7,8,0,Matches,2020
147,Ousmane Dembélé,fr FRA,FW,Barcelona,22,1997,1.5,0,0,0,0,0,0,1,0.0,1,3,1,2,0,0,0,0,Matches,2020
148,Merih Demiral,tr TUR,DF,Juventus,21,1998,1.0,2,2,2,0,0,1,1,100.0,0,2,2,0,1,3,4,0,Matches,2020
149,Kerem Demirbay,de GER,MF,Leverkusen,26,1993,4.1,11,7,3,7,1,4,10,40.0,6,2,0,2,2,13,4,0,Matches,2020
150,Diego Demme,de GER,MF,RB Leipzig,27,1991,4.1,11,8,6,5,0,4,10,40.0,6,5,0,5,3,14,6,0,Matches,2020
151,Diego Demme,de GER,MF,Napoli,27,1991,1.4,0,0,0,0,0,0,5,0.0,5,0,0,0,4,4,1,0,Matches,2020
152,Jason Denayer,be BEL,"DF,MF",Lyon,24,1995,8.7,9,7,6,3,0,2,5,40.0,3,12,10,2,7,16,33,0,Matches,2020
153,Emmanuel Dennis,ng NGA,"FW,MF",Club Brugge,21,1997,5.0,13,8,6,2,5,6,14,42.9,8,12,0,12,3,16,0,0,Matches,2020
154,Dentinho,br BRA,"FW,DF",Shakhtar,30,1989,0.2,0,0,0,0,0,0,1,0.0,1,0,0,0,0,0,0,0,Matches,2020
155,Sergiño Dest,us USA,DF,Ajax,18,2000,4.5,9,5,6,3,0,4,5,80.0,1,2,2,0,3,12,3,0,Matches,2020
156,Sébastien Dewaest,be BEL,DF,Genk,28,1991,4.0,6,5,4,1,1,4,6,66.7,2,2,2,0,2,8,28,0,Matches,2020
157,Giovanni Di Lorenzo,it ITA,"DF,MF",Napoli,25,1993,8.0,14,11,9,5,0,9,14,64.3,5,8,2,6,2,16,14,0,Matches,2020
158,Ángel Di María,ar ARG,"FW,MF",Paris S-G,31,1988,8.3,9,7,4,3,2,3,18,16.7,15,11,0,11,4,13,7,0,Matches,2020
159,Moussa Diaby,fr FRA,"MF,FW",Leverkusen,20,1999,2.0,1,0,0,1,0,0,2,0.0,2,1,0,1,0,1,0,0,Matches,2020
160,Mbaye Diagne,sn SEN,FW,Club Brugge,27,1991,0.5,1,0,0,1,0,0,1,0.0,1,0,0,0,0,1,0,0,Matches,2020
161,Mouctar Diakhaby,gn GUI,DF,Valencia,22,1996,3.4,7,2,5,2,0,3,4,75.0,1,7,6,1,5,12,22,0,Matches,2020
162,Abdou Diallo,sn SEN,DF,Paris S-G,23,1996,1.2,2,1,1,1,0,1,1,100.0,0,2,1,1,0,2,1,0,Matches,2020
163,Rúben Dias,pt POR,DF,Benfica,22,1997,6.0,5,3,4,1,0,4,4,100.0,0,8,6,2,5,10,33,0,Matches,2020
164,Krépin Diatta,sn SEN,"FW,MF",Club Brugge,20,1999,4.8,9,5,5,2,2,6,9,66.7,3,2,0,2,5,14,3,0,Matches,2020
165,Brahim Díaz,es ESP,FW,Real Madrid,19,1999,0.2,0,0,0,0,0,0,0,,0,0,0,0,0,0,0,0,Matches,2020
166,Eric Dier,eng ENG,"DF,MF",Tottenham,25,1994,3.5,2,2,1,1,0,1,5,20.0,4,4,1,3,4,6,8,0,Matches,2020
167,Emir Dilaver,at AUT,DF,Dinamo Zagreb,28,1991,6.0,5,2,5,0,0,2,5,40.0,3,9,6,3,12,17,33,0,Matches,2020
168,Tiago Djaló,pt POR,DF,Lille,19,2000,3.0,4,4,4,0,0,3,4,75.0,1,4,4,0,2,6,17,1,Matches,2020
169,Berat Djimsiti,al ALB,DF,Atalanta,26,1993,5.7,10,6,6,4,0,6,13,46.2,7,4,2,2,6,16,19,0,Matches,2020
170,Dodô,br BRA,DF,Shakhtar,20,1998,3.1,3,3,3,0,0,2,8,25.0,6,0,0,0,1,4,8,0,Matches,2020
171,Jaume Doménech,es ESP,GK,Valencia,28,1990,2.0,0,0,0,0,0,0,0,,0,0,0,0,1,1,3,0,Matches,2020
172,Ryan Donk,sr SUR,DF,Galatasaray,33,1986,4.0,5,2,2,3,0,3,4,75.0,1,3,3,0,6,11,15,0,Matches,2020
173,Gabriel Dos Santos,br BRA,DF,Lille,21,1997,6.0,12,7,8,4,0,5,7,71.4,2,11,6,5,13,25,25,0,Matches,2020
174,Aleksandar Dragović,at AUT,DF,Leverkusen,28,1991,1.0,2,2,1,1,0,1,1,100.0,0,0,0,0,2,4,2,0,Matches,2020
175,Julian Draxler,de GER,"MF,FW",Paris S-G,25,1993,0.8,0,0,0,0,0,0,0,,0,0,0,0,1,1,0,0,Matches,2020
176,Sebastián Driussi,ar ARG,MF,Zenit,23,1996,4.0,13,8,4,7,2,6,11,54.5,5,6,1,5,3,16,5,0,Matches,2020
177,Leo Dubois,fr FRA,DF,Lyon,24,1994,8.4,6,6,5,1,0,6,12,50.0,6,7,0,7,5,11,19,0,Matches,2020
178,Paulo Dybala,ar ARG,"FW,MF",Juventus,25,1993,3.5,1,1,1,0,0,0,3,0.0,3,4,1,3,1,2,0,0,Matches,2020
179,Artem Dzyuba,ru RUS,FW,Zenit,30,1988,6.0,5,4,3,1,1,2,6,33.3,4,2,0,2,1,6,2,0,Matches,2020
180,Éder,pt POR,FW,Loko Moscow,31,1987,3.8,1,1,0,0,1,0,0,,0,6,3,3,3,4,7,0,Matches,2020
181,Ederson,br BRA,GK,Manchester City,25,1993,7.5,0,0,0,0,0,0,0,,0,0,0,0,0,0,4,3,Matches,2020
182,Jurgen Ekkelenkamp,nl NED,MF,Ajax,19,2000,0.0,1,1,0,1,0,1,1,100.0,0,0,0,0,0,1,0,0,Matches,2020
183,Omar Elabdellaoui,no NOR,DF,Olympiacos,27,1991,5.1,5,2,3,2,0,1,2,50.0,1,1,0,1,6,11,13,0,Matches,2020
184,Elif Elmas,mk MKD,MF,Napoli,19,1999,1.2,0,0,0,0,0,0,2,0.0,2,2,1,1,0,0,1,0,Matches,2020
185,Christian Eriksen,dk DEN,MF,Tottenham,27,1992,3.3,5,3,0,5,0,3,11,27.3,8,1,0,1,0,5,4,0,Matches,2020
186,Aleksandr Erokhin,ru RUS,"MF,FW",Zenit,29,1989,1.8,0,0,0,0,0,0,0,,0,4,1,3,1,1,3,0,Matches,2020
187,Sebastiano Esposito,it ITA,"MF,FW",Inter,17,2002,0.6,0,0,0,0,0,0,0,,0,0,0,0,0,0,2,0,Matches,2020
188,Fabinho,br BRA,MF,Liverpool,25,1993,5.4,16,11,4,10,2,8,16,50.0,8,4,0,4,7,23,1,0,Matches,2020
189,Malachi Fagan-Walcott,eng ENG,DF,Tottenham,17,2002,0.0,1,1,1,0,0,1,1,100.0,0,0,0,0,0,1,0,0,Matches,2020
190,Radamel Falcao,co COL,"FW,MF",Galatasaray,33,1986,2.3,3,1,2,1,0,1,3,33.3,2,0,0,0,0,3,0,0,Matches,2020
191,Patrick Farkas,at AUT,DF,RB Salzburg,26,1992,0.1,1,1,0,1,0,1,2,50.0,1,0,0,0,0,1,0,0,Matches,2020
192,Ansu Fati,es ESP,FW,Barcelona,16,2002,1.3,2,0,1,0,1,2,6,33.3,4,0,0,0,1,3,0,0,Matches,2020
193,Sofiane Feghouli,dz ALG,"FW,MF",Galatasaray,29,1989,3.8,3,2,3,0,0,0,2,0.0,2,3,0,3,4,7,1,0,Matches,2020
194,Ljubomir Fejsa,rs SRB,MF,Benfica,30,1988,1.7,5,3,2,2,1,3,4,75.0,1,4,1,3,3,8,1,1,Matches,2020
195,Felipe,br BRA,DF,Atlético Madrid,30,1989,7.3,12,3,8,3,1,6,12,50.0,6,13,10,3,14,26,34,1,Matches,2020
196,João Félix,pt POR,"FW,MF",Atlético Madrid,19,1999,4.7,1,0,0,0,1,0,3,0.0,3,1,0,1,1,2,1,0,Matches,2020
197,Gedson Fernandes,pt POR,MF,Tottenham,20,1999,0.8,2,0,1,1,0,1,3,33.3,2,4,1,3,0,2,4,0,Matches,2020
198,Gedson Fernandes,pt POR,"MF,FW",Benfica,20,1999,1.5,5,2,4,0,1,1,6,16.7,5,3,1,2,1,6,0,0,Matches,2020
199,Fernandinho,br BRA,DF,Manchester City,34,1985,7.3,11,10,5,4,2,7,9,77.8,2,7,4,3,15,26,12,0,Matches,2020
200,Roberto Firmino,br BRA,"FW,MF",Liverpool,27,1991,7.0,13,12,5,6,2,1,10,10.0,9,6,0,6,3,16,2,0,Matches,2020
201,Junior Firpo,es ESP,"DF,FW",Barcelona,22,1996,3.0,5,3,3,2,0,3,7,42.9,4,1,1,0,4,9,4,0,Matches,2020
202,Alessandro Florenzi,it ITA,MF,Valencia,28,1991,0.1,0,0,0,0,0,0,0,,0,0,0,0,1,1,0,0,Matches,2020
203,Phil Foden,eng ENG,"MF,FW",Manchester City,19,2000,2.8,4,2,2,1,1,4,4,100.0,0,2,0,2,2,6,3,0,Matches,2020
204,José Fonte,pt POR,DF,Lille,35,1983,4.0,7,7,5,2,0,6,6,100.0,0,4,2,2,3,10,19,0,Matches,2020
205,Emil Forsberg,se SWE,"MF,FW",RB Leipzig,27,1991,5.8,8,7,2,4,2,4,9,44.4,5,5,0,5,1,9,1,0,Matches,2020
206,Juan Foyth,ar ARG,DF,Tottenham,21,1998,2.2,4,2,4,0,0,2,3,66.7,1,2,2,0,2,6,7,0,Matches,2020
207,Remo Freuler,ch SUI,MF,Atalanta,27,1992,7.4,15,9,4,10,1,9,20,45.0,11,10,3,7,9,24,10,0,Matches,2020
208,Michal Frydrych,cz CZE,DF,Slavia Prague,29,1990,1.9,1,1,1,0,0,1,6,16.7,5,0,0,0,3,4,6,0,Matches,2020
209,Gabriel,br BRA,MF,Benfica,25,1993,4.9,16,10,7,9,0,7,21,33.3,14,6,2,4,16,32,10,0,Matches,2020
210,Gianluca Gaetano,it ITA,MF,Napoli,19,2000,0.2,0,0,0,0,0,0,0,,0,0,0,0,0,0,0,0,Matches,2020
211,Roberto Gagliardini,it ITA,MF,Inter,25,1994,2.4,6,2,4,2,0,3,4,75.0,1,4,0,4,2,8,2,0,Matches,2020
212,Kévin Gameiro,fr FRA,FW,Valencia,32,1987,3.5,0,0,0,0,0,0,5,0.0,5,0,0,0,0,0,0,0,Matches,2020
213,Idrissa Gana Gueye,sn SEN,MF,Paris S-G,29,1989,6.3,20,8,7,7,6,9,15,60.0,6,10,3,7,12,32,7,0,Matches,2020
214,Ezequiel Garay,ar ARG,DF,Valencia,32,1986,4.0,5,2,5,0,0,2,6,33.3,4,6,5,1,3,8,16,0,Matches,2020
215,Eric García,es ESP,DF,Manchester City,18,2001,2.0,4,1,2,2,0,2,3,66.7,1,0,0,0,1,5,4,0,Matches,2020
216,Mateo García,ar ARG,"FW,MF",Red Star,22,1996,5.4,19,13,8,10,1,8,30,26.7,22,6,0,6,7,26,7,0,Matches,2020
217,Mario Gavranović,ch SUI,FW,Dinamo Zagreb,29,1989,0.9,1,0,0,0,1,0,1,0.0,1,0,0,0,0,1,0,0,Matches,2020
218,Paulo Gazzaniga,ar ARG,GK,Tottenham,27,1992,4.0,0,0,0,0,0,0,0,,0,0,0,0,0,0,2,0,Matches,2020
219,Olivier Giroud,fr FRA,FW,Chelsea,32,1986,1.0,1,0,0,1,0,0,1,0.0,1,0,0,0,0,1,0,0,Matches,2020
220,Serge Gnabry,de GER,FW,Bayern Munich,24,1995,8.5,21,13,8,11,2,10,25,40.0,15,9,0,9,5,26,3,0,Matches,2020
221,Marko Gobeljić,rs SRB,DF,Red Star,26,1992,5.5,19,11,14,5,0,14,21,66.7,7,4,2,2,7,26,18,1,Matches,2020
222,Diego Godín,uy URU,DF,Inter,33,1986,5.0,16,4,13,3,0,9,14,64.3,5,10,5,5,15,31,15,0,Matches,2020
223,Amer Gojak,ba BIH,MF,Dinamo Zagreb,22,1997,1.9,9,7,7,1,1,4,5,80.0,1,3,1,2,0,9,2,0,Matches,2020
224,Pierluigi Gollini,it ITA,GK,Atalanta,24,1995,7.0,0,0,0,0,0,0,1,0.0,1,0,0,0,0,0,4,1,Matches,2020
225,Joe Gomez,eng ENG,DF,Liverpool,22,1997,5.7,9,4,7,1,1,5,8,62.5,3,3,0,3,15,24,10,0,Matches,2020
226,Maxi Gómez,uy URU,FW,Valencia,22,1996,4.7,1,0,0,1,0,0,2,0.0,2,1,1,0,1,2,8,0,Matches,2020
227,Papu Gómez,ar ARG,"MF,FW",Atalanta,31,1988,7.9,6,4,3,2,1,2,11,18.2,9,7,1,6,6,12,3,0,Matches,2020
228,Leon Goretzka,de GER,MF,Bayern Munich,24,1995,5.8,15,11,2,9,4,9,20,45.0,11,8,2,6,11,26,3,0,Matches,2020
229,Robin Gosens,de GER,DF,Atalanta,25,1994,7.3,23,14,4,18,1,12,17,70.6,5,8,0,8,11,34,15,0,Matches,2020
230,Mario Götze,de GER,"FW,MF",Dortmund,27,1992,0.8,3,2,2,0,1,0,1,0.0,1,0,0,0,0,3,0,0,Matches,2020
231,Amine Gouiri,dz ALG,FW,Lyon,19,2000,0.1,0,0,0,0,0,0,0,,0,0,0,0,0,0,0,0,Matches,2020
232,Antoine Griezmann,fr FRA,"FW,MF",Barcelona,28,1991,7.3,7,3,2,1,4,3,12,25.0,9,5,0,5,6,13,5,1,Matches,2020
233,Álex Grimaldo,es ESP,DF,Benfica,23,1995,6.0,9,7,4,3,2,5,11,45.5,6,9,3,6,9,18,18,0,Matches,2020
234,Gonçalo Guedes,pt POR,"FW,MF",Valencia,22,1996,2.2,4,4,2,2,0,1,2,50.0,1,1,0,1,0,4,0,0,Matches,2020
235,Raphaël Guerreiro,pt POR,"DF,MF",Dortmund,25,1993,6.1,6,3,4,2,0,0,2,0.0,2,4,0,4,10,16,6,0,Matches,2020
236,Guilherme,br BRA,MF,Olympiacos,28,1991,5.0,10,3,9,1,0,7,17,41.2,10,9,3,6,3,13,6,1,Matches,2020
237,Bruno Guimarães,br BRA,MF,Lyon,21,1997,3.3,8,4,5,1,2,2,7,28.6,5,4,0,4,4,12,4,0,Matches,2020
238,Péter Gulácsi,hu HUN,GK,RB Leipzig,29,1990,9.7,0,0,0,0,0,0,0,,0,0,0,0,0,0,2,1,Matches,2020
239,İlkay Gündoğan,de GER,MF,Manchester City,28,1990,9.0,11,5,6,3,2,8,23,34.8,15,7,2,5,11,22,6,1,Matches,2020
240,Erling Haaland,no NOR,FW,RB Salzburg,19,2000,4.1,1,1,0,0,1,1,5,20.0,4,0,0,0,1,2,6,0,Matches,2020
241,Erling Haaland,no NOR,FW,Dortmund,19,2000,2.0,3,2,0,1,2,1,2,50.0,1,1,1,0,2,5,3,0,Matches,2020
242,Ianis Hagi,ro ROU,MF,Genk,20,1998,1.6,2,1,0,1,1,0,4,0.0,4,3,0,3,1,3,0,0,Matches,2020
243,Amadou Haidara,ml MLI,"MF,FW",RB Leipzig,21,1998,3.0,7,7,6,1,0,6,12,50.0,6,4,0,4,8,15,4,0,Matches,2020
244,Izet Hajrović,ba BIH,MF,Dinamo Zagreb,27,1991,0.1,0,0,0,0,0,0,0,,0,0,0,0,0,0,0,0,Matches,2020
245,Achraf Hakimi,ma MAR,"MF,DF",Dortmund,20,1998,7.9,20,5,11,6,3,14,17,82.4,3,6,1,5,7,27,10,0,Matches,2020
246,Marcel Halstenberg,de GER,DF,RB Leipzig,27,1991,5.7,12,7,9,3,0,6,10,60.0,4,5,0,5,7,19,17,0,Matches,2020
247,Samir Handanović,si SVN,GK,Inter,35,1984,6.0,0,0,0,0,0,0,0,,0,0,0,0,0,0,2,0,Matches,2020
248,Taylor Harwood-Bellis,eng ENG,DF,Manchester City,17,2002,0.1,1,1,0,1,0,1,1,100.0,0,1,1,0,0,1,0,0,Matches,2020
249,Hans Hateboer,nl NED,DF,Atalanta,25,1994,6.6,8,3,4,4,0,4,16,25.0,12,10,1,9,7,15,12,1,Matches,2020
250,Kai Havertz,de GER,"MF,FW",Leverkusen,20,1999,4.8,2,1,2,0,0,1,4,25.0,3,2,0,2,1,3,5,0,Matches,2020
251,Eden Hazard,be BEL,FW,Real Madrid,28,1991,5.0,3,3,1,0,2,1,6,16.7,5,0,0,0,3,6,0,0,Matches,2020
252,Thorgan Hazard,be BEL,"FW,MF",Dortmund,26,1993,5.3,10,8,2,6,2,4,15,26.7,11,6,0,6,1,11,1,0,Matches,2020
253,Hwang Hee-chan,kr KOR,FW,RB Salzburg,23,1996,6.0,3,2,0,2,1,0,1,0.0,1,1,0,1,1,4,1,0,Matches,2020
254,Jordan Henderson,eng ENG,MF,Liverpool,29,1990,5.7,11,7,2,8,1,3,8,37.5,5,7,0,7,8,19,2,0,Matches,2020
255,Mario Hermoso,es ESP,DF,Atlético Madrid,24,1995,3.9,4,3,2,2,0,1,3,33.3,2,2,0,2,8,12,17,1,Matches,2020
256,Lucas Hernández,fr FRA,DF,Bayern Munich,23,1996,1.7,1,1,0,1,0,0,1,0.0,1,2,0,2,2,3,2,0,Matches,2020
257,Ander Herrera,es ESP,MF,Paris S-G,29,1989,3.6,4,2,3,1,0,2,5,40.0,3,11,1,10,8,12,5,0,Matches,2020
258,Héctor Herrera,mx MEX,MF,Atlético Madrid,29,1990,2.9,1,0,1,0,0,1,8,12.5,7,1,0,1,2,3,5,0,Matches,2020
259,Son Heung-min,kr KOR,FW,Tottenham,27,1992,4.1,8,1,3,5,0,4,13,30.8,9,2,0,2,2,10,1,0,Matches,2020
260,Bryan Heynen,be BEL,"MF,FW",Genk,22,1997,2.9,6,5,2,4,0,3,12,25.0,9,6,4,2,6,12,3,0,Matches,2020
261,Gonzalo Higuaín,ar ARG,FW,Juventus,31,1987,5.7,0,0,0,0,0,0,5,0.0,5,4,1,3,0,0,2,0,Matches,2020
262,David Hovorka,cz CZE,DF,Slavia Prague,25,1993,3.0,3,3,2,1,0,2,3,66.7,1,8,2,6,5,8,9,0,Matches,2020
263,Benedikt Höwedes,de GER,DF,Loko Moscow,31,1988,6.0,5,4,3,1,1,2,7,28.6,5,6,4,2,14,19,22,0,Matches,2020
264,Lukáš Hrádecký,fi FIN,GK,Leverkusen,29,1989,6.0,0,0,0,0,0,0,0,,0,0,0,0,1,1,1,2,Matches,2020
265,Patrik Hrošovský,sk SVK,MF,Genk,27,1992,4.6,8,5,3,4,1,2,6,33.3,4,5,3,2,5,13,4,0,Matches,2020
266,Callum Hudson-Odoi,eng ENG,"FW,MF",Chelsea,18,2000,2.9,1,1,1,0,0,0,2,0.0,2,1,0,1,2,3,0,1,Matches,2020
267,Mats Hummels,de GER,DF,Dortmund,30,1988,8.0,18,12,13,5,0,12,20,60.0,8,9,5,4,30,48,32,2,Matches,2020
268,Klaas-Jan Huntelaar,nl NED,FW,Ajax,35,1983,0.4,0,0,0,0,0,0,0,,0,0,0,0,0,0,0,0,Matches,2020
269,Josef Hušbauer,cz CZE,MF,Slavia Prague,29,1990,2.3,2,1,0,1,1,1,3,33.3,2,5,0,5,3,5,1,0,Matches,2020
270,Roger Ibanez,br BRA,"DF,FW",Atalanta,20,1998,0.2,0,0,0,0,0,0,0,,0,0,0,0,0,0,1,0,Matches,2020
271,Mauro Icardi,ar ARG,FW,Paris S-G,26,1993,5.3,1,1,0,1,0,0,1,0.0,1,3,0,3,0,1,5,0,Matches,2020
272,Brian Idowu,ng NGA,DF,Loko Moscow,27,1992,2.7,4,3,2,2,0,2,5,40.0,3,5,0,5,4,8,11,0,Matches,2020
273,Vladislav Ignatyev,ru RUS,"DF,MF",Loko Moscow,32,1987,4.9,16,10,12,4,0,8,17,47.1,9,11,5,6,5,21,17,0,Matches,2020
274,Jonathan Ikone,fr FRA,"MF,FW",Lille,21,1998,2.7,1,0,0,0,1,1,4,25.0,3,2,0,2,0,1,0,0,Matches,2020
275,Josip Iličić,si SVN,"FW,MF",Atalanta,31,1988,5.7,4,1,0,2,2,2,7,28.6,5,1,0,1,4,8,3,0,Matches,2020
276,Selçuk İnan,tr TUR,"MF,FW",Galatasaray,34,1985,0.7,0,0,0,0,0,0,0,,0,0,0,0,2,2,2,0,Matches,2020
277,Lorenzo Insigne,it ITA,"MF,FW",Napoli,28,1991,3.9,5,3,2,2,1,3,13,23.1,10,3,0,3,6,11,0,1,Matches,2020
278,Isco,es ESP,"MF,FW",Real Madrid,27,1992,3.0,6,3,4,1,1,2,5,40.0,3,1,0,1,3,9,0,0,Matches,2020
279,Ismaily,br BRA,DF,Shakhtar,29,1990,6.0,16,12,12,2,2,4,9,44.4,5,8,0,8,13,29,24,1,Matches,2020
280,Junya Ito,jp JPN,"MF,FW",Genk,26,1993,4.9,11,6,4,5,2,2,9,22.2,7,6,0,6,4,15,7,0,Matches,2020
281,Mirko Ivanić,me MNE,MF,Red Star,25,1993,1.2,3,1,0,3,0,1,8,12.5,7,2,0,2,2,5,1,1,Matches,2020
282,Branislav Ivanović,rs SRB,DF,Zenit,35,1984,5.8,3,2,1,1,1,1,1,100.0,0,5,3,2,5,8,34,0,Matches,2020
283,Luka Ivanušec,hr CRO,"MF,DF",Dinamo Zagreb,20,1998,1.1,2,1,0,1,1,0,2,0.0,2,0,0,0,1,3,3,0,Matches,2020
284,Reece James,eng ENG,DF,Chelsea,19,1999,4.2,7,5,5,2,0,6,13,46.2,7,6,2,4,5,12,11,0,Matches,2020
285,Jardel,br BRA,DF,Benfica,33,1986,1.8,3,1,1,1,1,2,4,50.0,2,2,2,0,3,6,9,0,Matches,2020
286,Léo Jardim,br BRA,GK,Lille,24,1995,0.2,0,0,0,0,0,0,0,,0,0,0,0,0,0,0,0,Matches,2020
287,Gabriel Jesus,br BRA,"FW,MF",Manchester City,22,1997,6.5,6,3,1,2,3,3,8,37.5,5,6,2,4,8,14,3,0,Matches,2020
288,Frenkie de Jong,nl NED,MF,Barcelona,22,1997,8.3,16,10,7,6,3,5,20,25.0,15,6,1,5,12,28,5,0,Matches,2020
289,Siem de Jong,nl NED,MF,Ajax,30,1989,0.1,1,0,1,0,0,0,1,0.0,1,0,0,0,0,1,0,0,Matches,2020
290,Jorginho,it ITA,MF,Chelsea,27,1991,6.8,21,10,6,12,3,8,27,29.6,19,7,1,6,13,34,4,0,Matches,2020
291,Jota,pt POR,FW,Benfica,20,1999,0.7,0,0,0,0,0,0,2,0.0,2,0,0,0,0,0,0,0,Matches,2020
292,Dušan Jovančić,rs SRB,MF,Red Star,28,1990,2.0,5,4,0,4,1,1,3,33.3,2,5,2,3,4,9,0,0,Matches,2020
293,Luka Jović,rs SRB,FW,Real Madrid,21,1997,1.3,1,1,0,0,1,0,1,0.0,1,0,0,0,0,1,2,0,Matches,2020
294,Vinicius Júnior,br BRA,FW,Real Madrid,19,2000,2.2,5,2,1,2,2,1,2,50.0,1,0,0,0,1,6,0,0,Matches,2020
295,Zlatko Junuzović,at AUT,MF,RB Salzburg,31,1987,5.6,11,6,5,5,1,9,19,47.4,10,10,5,5,10,21,5,0,Matches,2020
296,Damian Kądzior,pl POL,"MF,FW",Dinamo Zagreb,27,1992,0.7,0,0,0,0,0,0,2,0.0,2,1,1,0,0,0,0,0,Matches,2020
297,Kevin Kampl,si SVN,MF,RB Leipzig,28,1990,3.2,4,1,3,1,0,3,5,60.0,2,0,0,0,5,9,6,0,Matches,2020
298,Harry Kane,eng ENG,FW,Tottenham,26,1993,5.0,3,3,0,2,1,0,2,0.0,2,2,0,2,0,3,4,0,Matches,2020
299,Lee Kang-in,kr KOR,"MF,FW",Valencia,18,2001,1.4,3,3,1,1,1,3,5,60.0,2,4,0,4,0,3,0,0,Matches,2020
300,N'Golo Kanté,fr FRA,MF,Chelsea,28,1991,4.0,10,4,3,7,0,4,10,40.0,6,8,1,7,9,19,3,1,Matches,2020
301,Vyacheslav Karavayev,ru RUS,DF,Zenit,24,1995,4.6,13,9,11,1,1,6,12,50.0,6,1,0,1,4,17,13,0,Matches,2020
302,Thilo Kehrer,de GER,DF,Paris S-G,22,1996,4.2,14,11,7,7,0,7,10,70.0,3,8,3,5,3,17,6,0,Matches,2020
303,Naby Keïta,gn GUI,"MF,FW",Liverpool,24,1995,2.8,9,7,4,5,0,2,6,33.3,4,1,0,1,2,11,2,0,Matches,2020
304,Mikhail Kerzhakov,ru RUS,GK,Zenit,32,1987,4.0,0,0,0,0,0,0,0,,0,0,0,0,1,1,0,0,Matches,2020
305,Sami Khedira,de GER,MF,Juventus,32,1987,2.9,7,4,3,2,2,1,3,33.3,2,3,1,2,3,10,5,0,Matches,2020
306,Joshua Kimmich,de GER,"DF,MF",Bayern Munich,24,1995,10.0,15,8,2,9,4,9,19,47.4,10,6,2,4,10,25,11,1,Matches,2020
307,Presnel Kimpembe,fr FRA,DF,Paris S-G,23,1995,10.0,22,14,14,8,0,12,16,75.0,4,7,3,4,15,37,32,1,Matches,2020
308,Simon Kjær,dk DEN,DF,Atalanta,30,1989,1.0,4,2,3,1,0,4,6,66.7,2,0,0,0,0,4,6,0,Matches,2020
309,Lukas Klostermann,de GER,DF,RB Leipzig,23,1996,9.0,11,7,8,3,0,5,15,33.3,10,11,4,7,16,27,26,1,Matches,2020
310,Anton Kochenkov,kg KGZ,GK,Loko Moscow,32,1987,1.0,0,0,0,0,0,0,0,,0,0,0,0,0,0,1,0,Matches,2020
311,Sekou Koita,ml MLI,MF,RB Salzburg,19,1999,0.0,0,0,0,0,0,0,0,,0,0,0,0,1,1,0,0,Matches,2020
312,Koke,es ESP,MF,Atlético Madrid,27,1992,8.8,16,9,9,5,2,8,26,30.8,18,3,0,3,7,23,13,1,Matches,2020
313,Ondřej Kolář,cz CZE,GK,Slavia Prague,24,1994,6.0,1,1,1,0,0,1,2,50.0,1,2,0,2,0,1,4,0,Matches,2020
314,Aleksandr Kolomeytsev,ru RUS,MF,Loko Moscow,30,1989,0.2,0,0,0,0,0,0,1,0.0,1,0,0,0,0,0,0,0,Matches,2020
315,Ibrahima Konaté,fr FRA,DF,RB Leipzig,20,1999,1.2,1,1,0,1,0,0,1,0.0,1,1,0,1,2,3,5,0,Matches,2020
316,Geoffrey Kondogbia,cf CTA,"MF,DF",Valencia,26,1993,4.5,18,9,4,12,2,6,10,60.0,4,11,3,8,13,31,7,0,Matches,2020
317,Youssouf Koné,ml MLI,DF,Lyon,24,1995,4.4,7,6,5,2,0,5,8,62.5,3,2,0,2,11,18,12,0,Matches,2020
318,Yevhen Konoplyanka,ua UKR,"FW,MF",Shakhtar,29,1989,2.0,1,1,0,0,1,1,4,25.0,3,3,1,2,1,2,0,0,Matches,2020
319,Odilon Kossonou,ci CIV,DF,Club Brugge,18,2001,2.0,3,3,2,1,0,3,3,100.0,0,1,1,0,1,4,5,0,Matches,2020
320,Kalidou Koulibaly,sn SEN,DF,Napoli,28,1991,7.0,14,10,11,2,1,8,16,50.0,8,16,10,6,12,26,31,0,Matches,2020
321,Mateo Kovačić,hr CRO,MF,Chelsea,25,1994,6.8,10,5,4,5,1,1,6,16.7,5,7,1,6,7,17,6,1,Matches,2020
322,Viktor Kovalenko,ua UKR,MF,Shakhtar,23,1996,3.7,6,4,2,4,0,2,5,40.0,3,1,0,1,2,8,3,0,Matches,2020
323,Toni Kroos,de GER,MF,Real Madrid,29,1990,6.0,15,12,5,6,4,6,18,33.3,12,4,0,4,9,24,2,0,Matches,2020
324,Grzegorz Krychowiak,pl POL,MF,Loko Moscow,29,1990,5.9,12,5,3,5,4,3,8,37.5,5,8,2,6,8,20,7,1,Matches,2020
325,Serhiy Kryvtsov,ua UKR,DF,Shakhtar,28,1991,6.0,5,3,3,1,1,3,4,75.0,1,11,10,1,4,9,23,2,Matches,2020
326,Ondřej Kúdela,cz CZE,DF,Slavia Prague,32,1987,6.0,5,4,3,2,0,3,6,50.0,3,5,1,4,10,15,9,0,Matches,2020
327,Daniil Kulikov,ru RUS,MF,Loko Moscow,21,1998,0.3,0,0,0,0,0,0,1,0.0,1,1,0,1,1,1,0,0,Matches,2020
328,Layvin Kurzawa,fr FRA,DF,Paris S-G,26,1992,2.3,5,3,4,1,0,2,3,66.7,1,1,1,0,6,11,6,0,Matches,2020
329,Daler Kuzyaev,ru RUS,MF,Zenit,26,1993,1.5,2,0,2,0,0,1,12,8.3,11,4,1,3,6,8,2,0,Matches,2020
330,Solomon Kvirkvelia,ge GEO,DF,Loko Moscow,27,1992,1.0,0,0,0,0,0,0,1,0.0,1,1,1,0,2,2,9,0,Matches,2020
331,Rajiv van La Parra,nl NED,FW,Red Star,28,1991,3.9,11,5,2,5,4,3,10,30.0,7,1,0,1,1,12,1,0,Matches,2020
332,Zakaria Labyad,ma MAR,FW,Ajax,26,1993,0.5,1,1,0,1,0,0,1,0.0,1,0,0,0,0,1,0,0,Matches,2020
333,Konrad Laimer,at AUT,"MF,DF",RB Leipzig,22,1997,7.9,38,21,14,20,4,19,46,41.3,27,19,2,17,4,42,5,0,Matches,2020
334,Érik Lamela,ar ARG,"MF,FW",Tottenham,27,1992,2.6,4,4,2,1,1,1,5,20.0,4,1,0,1,1,5,2,0,Matches,2020
335,Noa Lang,nl NED,FW,Ajax,20,1999,1.4,8,6,2,3,3,2,4,50.0,2,1,0,1,3,11,0,0,Matches,2020
336,Aymeric Laporte,es ESP,DF,Manchester City,25,1994,2.4,2,0,1,1,0,2,3,66.7,1,2,1,1,4,6,5,0,Matches,2020
337,Valentino Lazaro,at AUT,"DF,FW",Inter,23,1996,1.2,2,2,2,0,0,1,4,25.0,3,2,0,2,1,3,3,0,Matches,2020
338,Thomas Lemar,fr FRA,MF,Atlético Madrid,23,1995,2.6,2,2,1,0,1,1,2,50.0,1,2,0,2,2,4,1,0,Matches,2020
339,Mario Lemina,ga GAB,MF,Galatasaray,25,1993,3.7,8,6,3,4,1,2,9,22.2,7,4,0,4,4,12,6,0,Matches,2020
340,Clément Lenglet,fr FRA,DF,Barcelona,24,1995,8.0,6,4,3,2,1,5,10,50.0,5,17,9,8,10,16,22,0,Matches,2020
341,Marin Leovac,hr CRO,"DF,MF",Dinamo Zagreb,30,1988,5.0,8,6,3,5,0,4,13,30.8,9,2,2,0,8,16,11,0,Matches,2020
342,Robert Lewandowski,pl POL,FW,Bayern Munich,30,1988,9.8,10,6,2,6,2,2,10,20.0,8,5,0,5,2,12,8,0,Matches,2020
343,Matthijs de Ligt,nl NED,DF,Juventus,19,1999,6.0,7,5,5,2,0,5,5,100.0,0,8,5,3,6,13,20,0,Matches,2020
344,Dominik Livaković,hr CRO,GK,Dinamo Zagreb,24,1995,6.0,0,0,0,0,0,0,0,,0,1,0,1,0,0,2,1,Matches,2020
345,Fernando Llorente,es ESP,FW,Napoli,34,1985,1.0,1,1,1,0,0,0,2,0.0,2,2,0,2,1,2,6,0,Matches,2020
346,Marcos Llorente,es ESP,"MF,FW",Atlético Madrid,24,1995,2.3,2,0,0,1,1,1,6,16.7,5,1,1,0,0,2,7,0,Matches,2020
347,Hugo Lloris,fr FRA,GK,Tottenham,32,1986,4.0,0,0,0,0,0,0,0,,0,0,0,0,0,0,3,0,Matches,2020
348,Giovani Lo Celso,ar ARG,"MF,FW",Tottenham,23,1996,3.7,9,3,3,5,1,8,17,47.1,9,5,1,4,5,14,5,0,Matches,2020
349,Stanislav Lobotka,sk SVK,MF,Napoli,24,1994,0.5,0,0,0,0,0,0,0,,0,1,0,1,0,0,0,0,Matches,2020
350,Renan Lodi,br BRA,DF,Atlético Madrid,21,1998,8.4,23,15,16,3,4,12,22,54.5,10,7,0,7,16,39,25,0,Matches,2020
351,Ademola Lookman,ng NGA,FW,RB Leipzig,21,1997,0.8,0,0,0,0,0,0,1,0.0,1,0,0,0,0,0,0,0,Matches,2020
352,Anthony Lopes,pt POR,GK,Lyon,28,1990,10.0,0,0,0,0,0,0,1,0.0,1,0,0,0,0,0,2,1,Matches,2020
353,Maximiliano Lovera,ar ARG,"FW,MF",Olympiacos,20,1999,1.1,0,0,0,0,0,0,2,0.0,2,0,0,0,0,0,0,0,Matches,2020
354,Dejan Lovren,hr CRO,DF,Liverpool,30,1989,2.6,3,2,0,3,0,2,2,100.0,0,3,2,1,2,5,7,1,Matches,2020
355,Hirving Lozano,mx MEX,"FW,MF",Napoli,24,1995,4.6,4,4,4,0,0,2,7,28.6,5,6,0,6,4,8,1,0,Matches,2020
356,Caio Lucas Fernandes,br BRA,"MF,FW",Benfica,25,1994,0.4,0,0,0,0,0,0,0,,0,0,0,0,0,0,0,0,Matches,2020
357,Jean Lucas,br BRA,MF,Lyon,21,1998,0.0,1,0,0,0,1,1,1,100.0,0,0,0,0,0,1,0,0,Matches,2020
358,Jhon Lucumí,co COL,DF,Genk,21,1998,6.0,9,4,6,3,0,4,9,44.4,5,15,7,8,15,24,25,1,Matches,2020
359,Florentino Luís,pt POR,MF,Benfica,19,1999,2.0,12,8,4,6,2,3,11,27.3,8,0,0,0,2,14,3,0,Matches,2020
360,José Luis Gayà,es ESP,DF,Valencia,24,1995,6.0,15,9,10,5,0,6,11,54.5,5,8,3,5,3,18,17,0,Matches,2020
361,José Luis Palomino,ar ARG,DF,Atalanta,29,1990,6.3,25,15,19,6,0,14,18,77.8,4,8,5,3,17,42,16,1,Matches,2020
362,Romelu Lukaku,be BEL,FW,Inter,26,1993,4.5,2,1,1,1,0,0,2,0.0,2,3,0,3,1,3,2,0,Matches,2020
363,Andrey Lunyov,ru RUS,GK,Zenit,27,1991,2.0,0,0,0,0,0,0,0,,0,0,0,0,0,0,0,0,Matches,2020
364,Sebastiano Luperto,it ITA,DF,Napoli,22,1996,1.5,0,0,0,0,0,0,1,0.0,1,2,1,1,3,3,6,0,Matches,2020
365,Christian Luyindama,cd COD,DF,Galatasaray,25,1994,4.0,11,6,10,1,0,7,13,53.8,6,11,5,6,4,15,17,0,Matches,2020
366,Stanislav Magkeev,ru RUS,DF,Loko Moscow,20,1999,0.2,0,0,0,0,0,0,0,,0,0,0,0,0,0,1,0,Matches,2020
367,Riyad Mahrez,dz ALG,"FW,MF",Manchester City,28,1991,6.4,9,7,2,5,2,5,19,26.3,14,5,0,5,5,14,1,0,Matches,2020
368,Thiago Maia,br BRA,FW,Lille,22,1997,0.7,0,0,0,0,0,0,3,0.0,3,3,0,3,1,1,0,0,Matches,2020
369,Mike Maignan,fr FRA,GK,Lille,24,1995,5.8,0,0,0,0,0,0,0,,0,0,0,0,0,0,2,0,Matches,2020
370,Lovro Majer,hr CRO,MF,Dinamo Zagreb,21,1998,0.1,0,0,0,0,0,0,0,,0,0,0,0,0,0,0,0,Matches,2020
371,Róbert Mak,sk SVK,MF,Zenit,28,1991,0.1,0,0,0,0,0,0,0,,0,0,0,0,0,0,0,0,Matches,2020
372,Nikola Maksimović,rs SRB,DF,Napoli,27,1991,3.0,6,5,4,2,0,2,3,66.7,1,4,2,2,6,12,11,0,Matches,2020
373,Kévin Malcuit,ma MAR,DF,Napoli,28,1991,1.6,6,4,4,2,0,4,4,100.0,0,0,0,0,3,9,5,0,Matches,2020
374,Ruslan Malinovskyi,ua UKR,MF,Atalanta,26,1993,2.9,4,3,3,1,0,2,9,22.2,7,2,0,2,2,6,3,0,Matches,2020
375,Reinildo Mandava,mz MOZ,DF,Lille,25,1994,2.0,10,5,5,4,1,5,9,55.6,4,1,0,1,3,13,3,0,Matches,2020
376,Sadio Mané,sn SEN,FW,Liverpool,27,1992,7.0,13,6,6,3,4,5,10,50.0,5,3,0,3,4,17,2,0,Matches,2020
377,Eliaquim Mangala,fr FRA,DF,Valencia,28,1991,1.0,2,1,1,1,0,1,2,50.0,1,0,0,0,2,4,6,0,Matches,2020
378,Kostas Manolas,gr GRE,DF,Napoli,28,1991,6.0,3,2,3,0,0,1,3,33.3,2,9,5,4,7,10,38,2,Matches,2020
379,Fernando Marçal,br BRA,DF,Lyon,30,1989,5.6,9,1,7,2,0,1,4,25.0,3,6,3,3,12,21,35,1,Matches,2020
380,Marcão,br BRA,DF,Galatasaray,23,1996,6.0,14,8,10,4,0,7,9,77.8,2,4,1,3,10,24,25,1,Matches,2020
381,Marcelo,br BRA,DF,Real Madrid,31,1988,3.0,3,2,1,1,1,1,2,50.0,1,3,0,3,5,8,4,0,Matches,2020
382,Marcelo,br BRA,DF,Lyon,32,1987,8.1,8,6,6,2,0,5,5,100.0,0,6,5,1,11,19,40,0,Matches,2020
383,José María Giménez,uy URU,DF,Atlético Madrid,24,1995,3.3,3,2,3,0,0,2,4,50.0,2,5,4,1,1,4,20,0,Matches,2020
384,Mariano,br BRA,DF,Galatasaray,33,1986,6.0,10,9,8,2,0,6,12,50.0,6,9,1,8,15,25,6,1,Matches,2020
385,Marko Marin,de GER,"MF,FW",Red Star,30,1989,6.0,6,4,2,3,1,2,11,18.2,9,3,1,2,3,9,3,1,Matches,2020
386,Guilherme Marinato,ru RUS,GK,Loko Moscow,33,1985,5.0,1,0,1,0,0,1,1,100.0,0,0,0,0,0,1,4,1,Matches,2020
387,João Mário,pt POR,"MF,FW",Loko Moscow,26,1993,3.9,3,0,2,1,0,0,6,0.0,6,8,0,8,7,10,3,0,Matches,2020
388,Marlos,ua UKR,"FW,MF",Shakhtar,31,1988,4.1,4,2,2,2,0,1,2,50.0,1,6,0,6,1,5,0,0,Matches,2020
389,Marquinhos,br BRA,"MF,DF",Paris S-G,25,1994,10.8,22,9,11,11,0,10,14,71.4,4,20,12,8,17,39,28,0,Matches,2020
390,Javi Martínez,es ESP,"DF,MF",Bayern Munich,30,1988,3.8,7,5,3,3,1,4,6,66.7,2,5,2,3,4,11,4,0,Matches,2020
391,Lautaro Martínez,ar ARG,FW,Inter,21,1997,5.8,6,2,0,5,1,2,10,20.0,8,4,0,4,2,8,1,0,Matches,2020
392,Lisandro Martínez,ar ARG,"MF,DF",Ajax,21,1998,6.0,13,7,5,8,0,7,19,36.8,12,6,2,4,10,23,16,2,Matches,2020
393,Andrea Masiello,it ITA,DF,Atalanta,33,1986,2.4,4,2,3,1,0,2,5,40.0,3,2,0,2,8,12,10,0,Matches,2020
394,Lukáš Masopust,cz CZE,FW,Slavia Prague,26,1993,5.2,5,4,1,4,0,0,12,0.0,12,8,0,8,4,9,0,0,Matches,2020
395,Giorgos Masouras,gr GRE,"FW,MF",Olympiacos,25,1994,4.7,15,12,8,5,2,9,18,50.0,9,5,0,5,7,22,5,0,Matches,2020
396,Clinton Mata,ao ANG,DF,Club Brugge,26,1992,4.0,15,11,8,5,2,5,9,55.6,4,4,0,4,10,25,4,2,Matches,2020
397,Joël Matip,cm CMR,DF,Liverpool,27,1991,1.0,2,1,0,2,0,1,3,33.3,2,1,0,1,1,3,4,0,Matches,2020
398,Blaise Matuidi,fr FRA,MF,Juventus,32,1987,3.8,7,4,2,4,1,1,6,16.7,5,5,0,5,7,14,6,1,Matches,2020
399,Mykola Matviyenko,ua UKR,DF,Shakhtar,23,1996,5.9,7,3,6,1,0,5,13,38.5,8,2,1,1,15,22,36,0,Matches,2020
400,Eric Maxim Choupo-Moting,cm CMR,FW,Paris S-G,30,1989,1.4,2,1,1,1,0,0,2,0.0,2,0,0,0,1,3,1,0,Matches,2020
401,Noussair Mazraoui,ma MAR,"DF,MF",Ajax,21,1997,2.5,8,5,5,2,1,7,7,100.0,0,2,1,1,5,13,6,0,Matches,2020
402,Kylian Mbappé,fr FRA,FW,Paris S-G,20,1998,7.3,4,4,1,3,0,1,7,14.3,6,1,0,1,1,5,0,0,Matches,2020
403,Brandon Mechele,be BEL,DF,Club Brugge,26,1993,5.0,11,6,8,2,1,5,6,83.3,1,8,3,5,9,20,20,0,Matches,2020
404,Arthur Melo,br BRA,MF,Barcelona,22,1996,3.3,6,3,2,3,1,2,3,66.7,1,3,0,3,2,8,1,0,Matches,2020
405,Memphis,nl NED,"FW,MF",Lyon,25,1994,6.6,3,2,1,2,0,2,4,50.0,2,4,0,4,1,4,0,0,Matches,2020
406,Thiago Mendes,br BRA,MF,Lyon,27,1992,5.1,9,6,5,3,1,4,8,50.0,4,9,0,9,14,23,5,1,Matches,2020
407,Benjamin Mendy,fr FRA,DF,Manchester City,25,1994,4.9,6,4,5,0,1,5,9,55.6,4,2,1,1,7,13,8,0,Matches,2020
408,Ferland Mendy,fr FRA,DF,Real Madrid,24,1995,4.5,8,4,7,1,0,1,6,16.7,5,1,0,1,5,13,4,0,Matches,2020
409,Alex Meret,it ITA,GK,Napoli,22,1997,6.0,0,0,0,0,0,0,0,,0,0,0,0,1,1,2,1,Matches,2020
410,Yassine Meriah,tn TUN,DF,Olympiacos,26,1993,6.0,6,2,4,2,0,3,5,60.0,2,4,3,1,8,14,38,3,Matches,2020
411,Dries Mertens,be BEL,FW,Napoli,32,1987,6.5,17,9,6,6,5,5,13,38.5,8,6,0,6,4,21,0,0,Matches,2020
412,Lionel Messi,ar ARG,FW,Barcelona,32,1987,7.4,2,1,0,1,1,0,5,0.0,5,3,0,3,2,4,0,0,Matches,2020
413,Thomas Meunier,be BEL,DF,Paris S-G,27,1991,5.0,10,7,7,3,0,8,15,53.3,7,3,2,1,11,21,11,0,Matches,2020
414,Simon Mignolet,be BEL,GK,Club Brugge,31,1988,6.0,0,0,0,0,0,0,0,,0,0,0,0,0,0,5,1,Matches,2020
415,Arkadiusz Milik,pl POL,FW,Napoli,25,1994,2.4,3,2,1,1,1,1,2,50.0,1,0,0,0,0,3,4,0,Matches,2020
416,Éder Militão,br BRA,DF,Real Madrid,21,1998,3.0,7,4,6,1,0,2,3,66.7,1,8,7,1,4,11,9,0,Matches,2020
417,James Milner,eng ENG,"MF,DF",Liverpool,33,1986,4.6,12,8,5,4,3,8,11,72.7,3,5,1,4,3,15,1,0,Matches,2020
418,Nemanja Milunović,rs SRB,DF,Red Star,30,1989,6.0,13,8,9,4,0,6,13,46.2,7,10,10,0,11,24,35,2,Matches,2020
419,Takumi Minamino,jp JPN,MF,RB Salzburg,24,1995,5.6,7,3,4,2,1,1,18,5.6,17,3,0,3,3,10,2,0,Matches,2020
420,Takumi Minamino,jp JPN,MF,Liverpool,24,1995,0.1,0,0,0,0,0,0,0,,0,1,0,1,0,0,0,0,Matches,2020
421,Aleksei Miranchuk,ru RUS,"FW,MF",Loko Moscow,23,1995,4.0,6,4,1,4,1,2,9,22.2,7,0,0,0,5,11,2,0,Matches,2020
422,Anton Miranchuk,ru RUS,MF,Loko Moscow,23,1995,1.0,3,2,0,3,0,2,2,100.0,0,1,0,1,0,3,0,0,Matches,2020
423,Matej Mitrović,hr CRO,DF,Club Brugge,25,1993,1.0,1,0,0,1,0,0,0,,0,0,0,0,0,1,8,0,Matches,2020
424,Luka Modrić,hr CRO,MF,Real Madrid,33,1985,4.3,4,3,0,3,1,1,6,16.7,5,1,0,1,8,12,4,1,Matches,2020
425,Monchu,es ESP,MF,Barcelona,19,1999,0.1,0,0,0,0,0,0,0,,0,0,0,0,0,0,2,0,Matches,2020
426,Emre Mor,tr TUR,"FW,MF",Galatasaray,22,1997,1.2,1,1,1,0,0,0,4,0.0,4,2,0,2,2,3,0,0,Matches,2020
427,Júnior Moraes,ua UKR,FW,Shakhtar,32,1987,5.8,4,1,1,3,0,1,11,9.1,10,0,0,0,2,6,4,0,Matches,2020
428,Álvaro Morata,es ESP,FW,Atlético Madrid,26,1992,5.4,5,5,1,2,2,2,4,50.0,2,7,1,6,4,9,2,0,Matches,2020
429,Nikola Moro,hr CRO,MF,Dinamo Zagreb,21,1998,4.6,11,5,2,9,0,5,13,38.5,8,7,1,6,11,22,6,1,Matches,2020
430,François Moubandje,ch SUI,DF,Dinamo Zagreb,29,1990,1.0,3,2,3,0,0,2,3,66.7,1,0,0,0,1,4,2,0,Matches,2020
431,Mason Mount,eng ENG,MF,Chelsea,20,1999,5.0,8,5,3,4,1,7,13,53.8,6,3,0,3,2,10,2,0,Matches,2020
432,Lucas Moura,br BRA,"FW,MF",Tottenham,26,1992,4.4,6,4,0,4,2,2,5,40.0,3,4,0,4,3,9,4,0,Matches,2020
433,Nordi Mukiele,fr FRA,DF,RB Leipzig,21,1997,7.8,26,13,16,7,3,13,17,76.5,4,8,1,7,12,38,28,2,Matches,2020
434,Thomas Müller,de GER,"MF,FW",Bayern Munich,29,1989,7.9,15,9,2,10,3,9,35,25.7,26,6,0,6,5,20,6,0,Matches,2020
435,Simone Muratore,it ITA,MF,Juventus,21,1998,0.0,0,0,0,0,0,0,0,,0,0,0,0,0,0,0,0,Matches,2020
436,Luis Muriel,co COL,FW,Atalanta,28,1991,2.4,2,1,1,1,0,0,3,0.0,3,1,0,1,0,2,2,0,Matches,2020
437,Fernando Muslera,uy URU,GK,Galatasaray,33,1986,6.0,0,0,0,0,0,0,1,0.0,1,0,0,0,1,1,1,0,Matches,2020
438,Yvon Mvogo,ch SUI,GK,RB Leipzig,25,1994,0.3,0,0,0,0,0,0,0,,0,0,0,0,0,0,0,0,Matches,2020
439,Enock Mwepu,zm ZAM,MF,RB Salzburg,21,1998,4.5,20,11,12,7,1,4,28,14.3,24,11,1,10,4,24,3,0,Matches,2020
440,Joakim Mæhle,dk DEN,DF,Genk,22,1997,6.0,20,11,11,4,5,11,14,78.6,3,6,4,2,8,28,13,0,Matches,2020
441,Nacho,es ESP,DF,Real Madrid,29,1990,0.5,2,2,0,2,0,1,1,100.0,0,1,0,1,1,3,0,0,Matches,2020
442,Yuto Nagatomo,jp JPN,DF,Galatasaray,32,1986,5.8,4,3,1,3,0,3,8,37.5,5,4,0,4,11,15,14,1,Matches,2020
443,Keylor Navas,cr CRC,GK,Paris S-G,32,1986,8.9,0,0,0,0,0,0,0,,0,0,0,0,1,1,2,0,Matches,2020
444,Tanguy Ndombele,fr FRA,MF,Tottenham,22,1996,3.8,10,5,3,5,2,6,15,40.0,9,2,0,2,6,16,4,0,Matches,2020
445,Dieumerci Ndongala,cd COD,"MF,FW",Genk,28,1991,1.3,2,0,0,2,0,0,1,0.0,1,0,0,0,0,2,1,0,Matches,2020
446,David Neres,br BRA,FW,Ajax,22,1997,2.0,3,0,0,1,2,1,2,50.0,1,0,0,0,2,5,0,0,Matches,2020
447,Neto,br BRA,GK,Barcelona,30,1989,1.0,0,0,0,0,0,0,0,,0,0,0,0,0,0,0,0,Matches,2020
448,Manuel Neuer,de GER,GK,Bayern Munich,33,1986,11.0,0,0,0,0,0,0,0,,0,0,0,0,1,1,1,1,Matches,2020
449,Neymar,br BRA,"MF,FW",Paris S-G,27,1992,6.5,7,3,1,1,5,2,8,25.0,6,5,0,5,2,9,0,0,Matches,2020
450,Tanguy Nianzou,fr FRA,MF,Paris S-G,17,2002,0.8,3,2,0,3,0,0,1,0.0,1,1,0,1,2,5,1,0,Matches,2020
451,Saúl Ñíguez,es ESP,"MF,DF",Atlético Madrid,24,1994,9.3,18,8,9,4,5,9,19,47.4,10,5,3,2,13,31,20,0,Matches,2020
452,Rasmus Nissen,dk DEN,DF,RB Salzburg,22,1997,5.9,20,12,13,6,1,13,25,52.0,12,10,3,7,5,25,21,1,Matches,2020
453,Christopher Nkunku,fr FRA,"FW,MF",RB Leipzig,21,1997,5.7,11,6,2,7,2,2,8,25.0,6,1,0,1,1,12,2,0,Matches,2020
454,Casper de Norre,be BEL,DF,Genk,22,1997,2.8,3,2,2,1,0,2,6,33.3,4,2,1,1,4,7,12,0,Matches,2020
455,Steven Nzonzi,fr FRA,"MF,DF",Galatasaray,30,1988,4.3,8,5,4,3,1,1,2,50.0,1,9,6,3,3,11,8,0,Matches,2020
456,Jan Oblak,si SVN,GK,Atlético Madrid,26,1993,9.3,0,0,0,0,0,0,0,,0,0,0,0,0,0,5,0,Matches,2020
457,Stephen Odey,ng NGA,FW,Genk,21,1998,0.1,0,0,0,0,0,0,0,,0,0,0,0,0,0,0,0,Matches,2020
458,Álvaro Odriozola,es ESP,DF,Bayern Munich,23,1995,0.2,0,0,0,0,0,0,0,,0,0,0,0,0,0,0,0,Matches,2020
459,Álvaro Odriozola,es ESP,DF,Real Madrid,23,1995,1.0,0,0,0,0,0,0,0,,0,1,1,0,0,0,3,0,Matches,2020
460,David Okereke,ng NGA,FW,Club Brugge,21,1997,1.9,2,2,1,0,1,0,2,0.0,2,1,0,1,0,2,0,0,Matches,2020
461,Masaya Okugawa,jp JPN,"MF,FW",RB Salzburg,23,1996,0.8,4,2,3,1,0,3,10,30.0,7,1,0,1,0,4,2,0,Matches,2020
462,Peter Olayinka,ng NGA,"FW,MF",Slavia Prague,23,1995,5.9,17,10,4,6,7,5,10,50.0,5,4,0,4,6,23,1,0,Matches,2020
463,Marco Olivieri,it ITA,FW,Juventus,20,1999,0.1,0,0,0,0,0,0,0,,0,0,0,0,0,0,0,0,Matches,2020
464,Dani Olmo,es ESP,MF,RB Leipzig,21,1998,1.4,1,1,0,1,0,0,1,0.0,1,2,0,2,0,1,0,0,Matches,2020
465,Dani Olmo,es ESP,"MF,FW",Dinamo Zagreb,21,1998,6.0,11,5,4,7,0,1,8,12.5,7,5,1,4,6,17,11,0,Matches,2020
466,André Onana,cm CMR,GK,Ajax,23,1996,6.0,0,0,0,0,0,0,0,,0,0,0,0,1,1,3,0,Matches,2020
467,Jérôme Onguéné,cm CMR,DF,RB Salzburg,21,1997,4.0,10,7,7,3,0,5,9,55.6,4,4,2,2,4,14,22,1,Matches,2020
468,Paul Onuachu,ng NGA,FW,Genk,25,1994,2.4,3,3,0,3,0,0,0,,0,2,0,2,0,3,3,0,Matches,2020
469,Loïs Openda,be BEL,FW,Club Brugge,19,2000,1.5,1,1,0,1,0,0,1,0.0,1,1,0,1,1,2,0,0,Matches,2020
470,Willi Orban,hu HUN,DF,RB Leipzig,26,1992,3.1,8,5,4,4,0,5,9,55.6,4,7,1,6,2,10,14,0,Matches,2020
471,Divock Origi,be BEL,FW,Liverpool,24,1995,2.1,3,2,1,1,1,3,4,75.0,1,1,0,1,0,3,0,0,Matches,2020
472,Mislav Oršić,hr CRO,"FW,MF",Dinamo Zagreb,26,1992,5.2,6,3,0,5,1,1,13,7.7,12,5,0,5,2,8,1,0,Matches,2020
473,Victor Osimhen,ng NGA,FW,Lille,20,1998,5.0,2,0,1,0,1,0,3,0.0,3,4,1,3,3,5,4,0,Matches,2020
474,Yordan Osorio,ve VEN,DF,Zenit,25,1994,3.6,4,3,4,0,0,3,5,60.0,2,13,8,5,8,12,17,0,Matches,2020
475,David Ospina,co COL,GK,Napoli,30,1988,2.0,0,0,0,0,0,0,0,,0,0,0,0,0,0,0,0,Matches,2020
476,Nicolás Otamendi,ar ARG,DF,Manchester City,31,1988,6.2,18,9,8,10,0,10,15,66.7,5,2,2,0,5,23,14,0,Matches,2020
477,Alex Oxlade-Chamberlain,eng ENG,"MF,FW",Liverpool,25,1993,3.1,7,4,1,4,2,4,8,50.0,4,6,0,6,3,10,0,0,Matches,2020
478,Şener Özbayraklı,tr TUR,"MF,DF",Galatasaray,29,1990,0.2,0,0,0,0,0,0,0,,0,0,0,0,0,0,0,0,Matches,2020
479,Magomed Ozdoyev,ru RUS,MF,Zenit,26,1992,5.1,14,10,6,6,2,4,17,23.5,13,7,1,6,15,29,16,0,Matches,2020
480,Joseph Paintsil,gh GHA,"MF,FW",Genk,21,1998,1.7,1,0,0,0,1,1,2,50.0,1,2,0,2,3,4,2,0,Matches,2020
481,Emerson Palmieri,it ITA,DF,Chelsea,24,1994,2.2,2,1,0,1,1,1,4,25.0,3,3,0,3,2,4,3,0,Matches,2020
482,Radovan Pankov,rs SRB,DF,Red Star,23,1995,0.2,1,1,1,0,0,1,2,50.0,1,0,0,0,1,2,2,0,Matches,2020
483,Leandro Paredes,ar ARG,MF,Paris S-G,25,1994,4.1,8,5,3,3,2,5,14,35.7,9,2,0,2,5,13,5,0,Matches,2020
484,Daniel Parejo,es ESP,MF,Valencia,30,1989,8.0,12,8,6,6,0,3,25,12.0,22,9,3,6,8,20,5,0,Matches,2020
485,Thomas Partey,gh GHA,MF,Atlético Madrid,26,1993,8.2,29,18,15,12,2,5,18,27.8,13,10,3,7,12,41,8,0,Matches,2020
486,Mario Pašalić,hr CRO,"MF,FW",Atalanta,24,1995,7.7,8,5,3,4,1,5,12,41.7,7,2,0,2,3,11,8,0,Matches,2020
487,Alan Patrick,br BRA,MF,Shakhtar,28,1991,5.5,6,3,3,2,1,3,17,17.6,14,5,0,5,6,12,2,0,Matches,2020
488,Paulinho,br BRA,"FW,MF",Leverkusen,19,2000,0.4,0,0,0,0,0,0,0,,0,0,0,0,0,0,0,0,Matches,2020
489,Gabriel Paulista,br BRA,DF,Valencia,28,1990,6.0,8,5,5,3,0,5,6,83.3,1,11,8,3,12,20,41,0,Matches,2020
490,Benjamin Pavard,fr FRA,DF,Bayern Munich,23,1996,7.1,9,8,2,4,3,4,7,57.1,3,3,0,3,9,18,18,0,Matches,2020
491,Milan Pavkov,rs SRB,FW,Red Star,25,1994,2.1,1,1,0,0,1,0,0,,0,1,0,1,0,1,4,0,Matches,2020
492,Pedro,es ESP,"MF,DF",Chelsea,32,1987,1.1,1,1,1,0,0,0,1,0.0,1,1,0,1,0,1,1,0,Matches,2020
493,Carles Pérez,es ESP,FW,Barcelona,21,1998,0.9,1,1,0,1,0,0,1,0.0,1,0,0,0,0,1,0,0,Matches,2020
494,Dino Perić,hr CRO,DF,Dinamo Zagreb,25,1994,5.0,17,13,12,4,1,4,6,66.7,2,7,4,3,11,28,24,1,Matches,2020
495,Ivan Perišić,hr CRO,FW,Bayern Munich,30,1989,4.7,3,3,1,1,1,2,11,18.2,9,3,0,3,5,8,4,0,Matches,2020
496,Bruno Petković,hr CRO,FW,Dinamo Zagreb,24,1994,5.1,6,5,2,3,1,2,3,66.7,1,5,1,4,1,7,0,0,Matches,2020
497,Njegoš Petrović,rs SRB,MF,Red Star,20,1999,3.4,8,5,5,3,0,4,11,36.4,7,9,1,8,2,10,2,0,Matches,2020
498,Jérémy Pied,fr FRA,DF,Lille,30,1989,1.0,5,3,3,2,0,3,7,42.9,4,3,0,3,2,7,3,0,Matches,2020
499,Gerard Piqué,es ESP,DF,Barcelona,32,1987,7.0,4,3,2,2,0,3,5,60.0,2,9,5,4,10,14,42,2,Matches,2020
500,Łukasz Piszczek,pl POL,DF,Dortmund,34,1985,4.0,9,8,4,4,1,4,13,30.8,9,1,0,1,9,18,12,0,Matches,2020
501,Pizzi,pt POR,"MF,FW",Benfica,29,1989,4.5,6,1,2,2,2,2,13,15.4,11,5,2,3,2,8,2,0,Matches,2020
502,Miralem Pjanić,ba BIH,MF,Juventus,29,1990,7.3,11,5,5,6,0,5,18,27.8,13,6,2,4,17,28,8,1,Matches,2020
503,Daniel Podence,pt POR,"FW,MF",Olympiacos,23,1995,5.1,5,4,2,2,1,3,5,60.0,2,3,0,3,2,7,3,0,Matches,2020
504,Matteo Politano,it ITA,"FW,MF",Napoli,25,1993,0.4,0,0,0,0,0,0,1,0.0,1,0,0,0,0,0,0,0,Matches,2020
505,Matteo Politano,it ITA,"FW,DF",Inter,25,1993,0.7,0,0,0,0,0,0,1,0.0,1,1,0,1,1,1,0,0,Matches,2020
506,Marin Pongračić,hr CRO,DF,RB Salzburg,21,1997,0.5,1,1,1,0,0,0,0,,0,0,0,0,1,2,1,0,Matches,2020
507,Yussuf Poulsen,dk DEN,"FW,MF",RB Leipzig,25,1994,6.4,7,3,0,4,3,1,6,16.7,5,6,3,3,1,8,5,0,Matches,2020
508,Quincy Promes,nl NED,"FW,MF",Ajax,27,1992,4.7,7,3,1,4,2,3,12,25.0,9,4,0,4,2,9,0,0,Matches,2020
509,Lukáš Provod,cz CZE,"FW,MF",Slavia Prague,22,1996,0.2,0,0,0,0,0,0,0,,0,0,0,0,0,0,0,0,Matches,2020
510,Christian Pulisic,us USA,"FW,MF",Chelsea,20,1998,3.0,5,3,3,1,1,3,6,50.0,3,1,0,1,0,5,2,0,Matches,2020
511,Andriy Pyatov,ua UKR,GK,Shakhtar,35,1984,6.0,0,0,0,0,0,0,0,,0,1,0,1,0,0,0,1,Matches,2020
512,Adrien Rabiot,fr FRA,MF,Juventus,24,1995,4.1,12,8,6,3,3,6,13,46.2,7,3,2,1,1,13,3,1,Matches,2020
513,Rafael,br BRA,DF,Lyon,29,1990,0.8,2,2,1,0,1,1,2,50.0,1,3,1,2,1,3,1,0,Matches,2020
514,Ivan Rakitić,hr CRO,MF,Barcelona,31,1988,3.8,6,5,5,1,0,3,7,42.9,4,4,2,2,10,16,2,1,Matches,2020
515,Yaroslav Rakitskiy,ua UKR,DF,Zenit,29,1989,5.0,6,4,3,2,1,3,3,100.0,0,6,4,2,8,14,32,0,Matches,2020
516,André Ramalho,br BRA,DF,RB Salzburg,27,1992,2.0,3,2,1,2,0,2,2,100.0,0,3,2,1,5,8,13,0,Matches,2020
517,Sergio Ramos,es ESP,DF,Real Madrid,33,1986,4.9,3,2,3,0,0,3,6,50.0,3,6,5,1,10,13,17,1,Matches,2020
518,Aaron Ramsey,wls WAL,MF,Juventus,28,1990,2.2,2,1,1,0,1,0,2,0.0,2,0,0,0,0,2,1,0,Matches,2020
519,Lazar Ranđelović,rs SRB,FW,Olympiacos,21,1997,1.0,2,2,1,1,0,2,5,40.0,3,0,0,0,0,2,1,0,Matches,2020
520,Jeff Reine-Adélaïde,fr FRA,"MF,FW",Lyon,21,1998,3.6,5,4,1,3,1,2,3,66.7,1,0,0,0,0,5,4,0,Matches,2020
521,Francisco Reis Ferreira,pt POR,DF,Benfica,22,1997,4.2,14,5,12,2,0,8,15,53.3,7,3,2,1,4,18,24,0,Matches,2020
522,Loïc Rémy,fr FRA,FW,Lille,32,1987,2.3,0,0,0,0,0,0,1,0.0,1,0,0,0,0,0,2,0,Matches,2020
523,Panagiotis Retsos,gr GRE,DF,Leverkusen,20,1998,1.1,7,6,3,4,0,5,9,55.6,4,4,0,4,2,9,2,1,Matches,2020
524,Marco Reus,de GER,"FW,MF",Dortmund,30,1989,4.0,9,6,3,3,3,1,9,11.1,8,4,1,3,1,10,11,0,Matches,2020
525,Gio Reyna,us USA,"FW,MF",Dortmund,16,2002,0.5,2,1,1,0,1,1,1,100.0,0,0,0,0,0,2,0,0,Matches,2020
526,Jander Ribeiro Santana,br BRA,DF,Red Star,31,1988,1.6,2,2,2,0,0,2,4,50.0,2,1,0,1,4,6,4,0,Matches,2020
527,Federico Ricca,uy URU,"DF,FW",Club Brugge,24,1994,3.0,9,7,5,3,1,6,7,85.7,1,2,1,1,3,12,2,0,Matches,2020
528,Sergio Rico,es ESP,GK,Paris S-G,25,1993,2.1,0,0,0,0,0,0,0,,0,0,0,0,0,0,0,0,Matches,2020
529,Mats Rits,be BEL,MF,Club Brugge,26,1993,4.4,6,2,2,3,1,2,7,28.6,5,4,1,3,4,10,5,0,Matches,2020
530,Sergi Roberto,es ESP,"DF,MF",Barcelona,27,1992,4.6,7,5,2,5,0,2,5,40.0,3,4,1,3,5,12,2,0,Matches,2020
531,Andrew Robertson,sct SCO,DF,Liverpool,25,1994,7.2,14,9,7,6,1,8,15,53.3,7,11,1,10,7,21,9,0,Matches,2020
532,Milan Rodić,rs SRB,DF,Red Star,28,1991,4.9,7,4,6,1,0,7,14,50.0,7,7,2,5,7,14,13,0,Matches,2020
533,Rodri,es ESP,MF,Manchester City,23,1996,6.9,21,11,8,10,3,10,24,41.7,14,3,0,3,9,30,5,0,Matches,2020
534,Rodrigo,es ESP,FW,Valencia,28,1991,5.8,4,3,0,4,0,0,5,0.0,5,1,0,1,4,8,7,0,Matches,2020
535,James Rodríguez,co COL,MF,Real Madrid,28,1991,0.9,1,0,1,0,0,0,3,0.0,3,0,0,0,0,1,1,1,Matches,2020
536,Rodrygo,br BRA,FW,Real Madrid,18,2001,3.7,6,4,2,3,1,2,4,50.0,2,2,0,2,4,10,2,0,Matches,2020
537,Cristiano Ronaldo,pt POR,FW,Juventus,34,1985,7.9,1,0,1,0,0,0,3,0.0,3,1,0,1,4,5,4,0,Matches,2020
538,Marten de Roon,nl NED,"MF,DF",Atalanta,28,1991,8.5,24,14,11,12,1,14,30,46.7,16,10,4,6,17,41,19,0,Matches,2020
539,Danny Rose,eng ENG,DF,Tottenham,29,1990,4.0,8,7,2,5,1,4,5,80.0,1,4,1,3,8,16,8,0,Matches,2020
540,Antonio Rüdiger,de GER,DF,Chelsea,26,1993,2.0,2,1,2,0,0,1,2,50.0,1,1,0,1,2,4,7,0,Matches,2020
541,Daniele Rugani,it ITA,DF,Juventus,25,1994,2.0,3,2,1,1,1,0,3,0.0,3,2,2,0,1,4,16,0,Matches,2020
542,Mário Rui,pt POR,DF,Napoli,28,1991,5.9,17,9,10,3,4,9,22,40.9,13,6,1,5,11,28,17,0,Matches,2020
543,Fabián Ruiz Peña,es ESP,MF,Napoli,23,1996,7.9,10,7,6,2,2,6,22,27.3,16,11,2,9,19,29,7,0,Matches,2020
544,Maciej Rybus,pl POL,DF,Loko Moscow,29,1989,5.0,9,3,7,1,1,5,7,71.4,2,7,4,3,13,22,16,0,Matches,2020
545,José Sá,pt POR,GK,Olympiacos,26,1993,6.0,0,0,0,0,0,0,0,,0,0,0,0,1,1,2,0,Matches,2020
546,Marcel Sabitzer,at AUT,"MF,FW",RB Leipzig,25,1994,8.9,6,3,1,5,0,3,26,11.5,23,6,1,5,9,15,5,0,Matches,2020
547,Mohamed Salah,eg EGY,FW,Liverpool,27,1992,8.1,2,1,0,0,2,0,2,0.0,2,2,0,2,0,2,0,0,Matches,2020
548,Andreas Samaris,gr GRE,MF,Benfica,30,1989,0.1,2,2,1,0,1,2,2,100.0,0,0,0,0,0,2,0,0,Matches,2020
549,Mbwana Samatta,tz TAN,FW,Genk,26,1992,5.7,2,1,1,1,0,0,1,0.0,1,4,1,3,0,2,4,0,Matches,2020
550,Renato Sanches,pt POR,"MF,FW",Lille,21,1997,1.4,2,1,1,1,0,0,3,0.0,3,2,0,2,4,6,1,0,Matches,2020
551,Alexis Sánchez,cl CHI,FW,Inter,30,1988,0.7,2,0,0,2,0,0,1,0.0,1,1,0,1,2,4,0,0,Matches,2020
552,Davinson Sánchez,co COL,DF,Tottenham,23,1996,5.0,8,6,7,1,0,5,7,71.4,2,6,4,2,6,14,13,0,Matches,2020
553,Jadon Sancho,eng ENG,"FW,MF",Dortmund,19,2000,7.2,1,1,1,0,0,1,8,12.5,7,1,0,1,2,3,1,0,Matches,2020
554,Alex Sandro,br BRA,DF,Juventus,28,1991,6.0,10,6,6,4,0,2,7,28.6,5,5,2,3,10,20,9,0,Matches,2020
555,Douglas Santos,br BRA,"DF,MF",Zenit,25,1994,5.6,15,10,10,4,1,5,21,23.8,16,6,0,6,12,27,17,0,Matches,2020
556,Pablo Sarabia,es ESP,"FW,MF",Paris S-G,27,1992,4.5,8,3,3,4,1,1,14,7.1,13,4,0,4,1,9,1,0,Matches,2020
557,Marcelo Saracchi,uy URU,DF,RB Leipzig,21,1998,1.8,4,3,4,0,0,2,6,33.3,4,0,0,0,2,6,4,0,Matches,2020
558,Stefan Savić,me MNE,DF,Atlético Madrid,28,1991,4.3,6,3,6,0,0,2,5,40.0,3,2,1,1,3,9,36,1,Matches,2020
559,Patrik Schick,cz CZE,FW,RB Leipzig,23,1996,2.7,3,0,0,2,1,0,3,0.0,3,2,0,2,1,4,4,0,Matches,2020
560,Marcel Schmelzer,de GER,FW,Dortmund,31,1988,0.0,0,0,0,0,0,0,0,,0,0,0,0,0,0,0,0,Matches,2020
561,Siebe Schrijvers,be BEL,"MF,FW",Club Brugge,23,1996,0.9,1,1,0,0,1,1,3,33.3,2,2,0,2,3,4,0,0,Matches,2020
562,Nico Schulz,de GER,"MF,DF",Dortmund,26,1993,2.5,0,0,0,0,0,0,3,0.0,3,1,0,1,1,1,2,0,Matches,2020
563,Perr Schuurs,nl NED,DF,Ajax,19,1999,1.2,0,0,0,0,0,0,1,0.0,1,1,0,1,2,2,1,0,Matches,2020
564,Haris Seferović,ch SUI,"FW,MF",Benfica,27,1992,2.3,1,1,0,1,0,0,1,0.0,1,1,0,1,0,1,0,0,Matches,2020
565,Nélson Semedo,pt POR,DF,Barcelona,25,1993,7.0,20,11,8,11,1,9,18,50.0,9,15,6,9,9,29,12,1,Matches,2020
566,Rúben Semedo,pt POR,DF,Olympiacos,25,1994,6.0,9,7,8,1,0,7,8,87.5,1,9,8,1,3,12,15,0,Matches,2020
567,Stefano Sensi,it ITA,MF,Inter,23,1995,2.1,1,0,1,0,0,0,5,0.0,5,1,0,1,2,3,2,0,Matches,2020
568,Jean Seri,ci CIV,MF,Galatasaray,28,1991,5.3,10,7,3,5,2,1,10,10.0,9,4,1,3,2,12,4,0,Matches,2020
569,Ryan Sessegnon,eng ENG,"FW,DF",Tottenham,19,2000,2.2,1,1,1,0,0,0,6,0.0,6,3,1,2,3,4,4,0,Matches,2020
570,Petr Ševčík,cz CZE,MF,Slavia Prague,25,1994,5.0,4,2,1,1,2,1,9,11.1,8,4,2,2,7,11,0,0,Matches,2020
571,Xherdan Shaqiri,ch SUI,MF,Liverpool,27,1991,0.0,0,0,0,0,0,0,0,,0,0,0,0,0,0,0,0,Matches,2020
572,Oleg Shatov,ru RUS,MF,Zenit,29,1990,2.6,3,2,2,1,0,1,4,25.0,3,3,0,3,3,6,4,0,Matches,2020
573,Danylo Sikan,ua UKR,FW,Shakhtar,18,2001,0.0,0,0,0,0,0,0,0,,0,0,0,0,0,0,0,0,Matches,2020
574,Bernardo Silva,pt POR,"FW,MF",Manchester City,24,1994,4.8,7,2,4,3,0,2,8,25.0,6,3,0,3,2,9,1,0,Matches,2020
575,David Silva,es ESP,MF,Manchester City,33,1986,1.4,0,0,0,0,0,0,1,0.0,1,0,0,0,2,2,0,0,Matches,2020
576,Rafa Silva,pt POR,"FW,MF",Benfica,26,1993,1.4,3,1,0,3,0,2,2,100.0,0,0,0,0,1,4,0,0,Matches,2020
577,Thiago Silva,br BRA,DF,Paris S-G,34,1984,9.0,12,6,7,5,0,4,7,57.1,3,13,8,5,13,25,40,0,Matches,2020
578,Daley Sinkgraven,nl NED,"DF,MF",Leverkusen,24,1995,1.1,2,1,0,2,0,1,1,100.0,0,1,0,1,1,3,3,1,Matches,2020
579,Moussa Sissoko,fr FRA,"MF,FW",Tottenham,29,1989,4.7,9,5,4,4,1,4,6,66.7,2,6,0,6,5,14,2,0,Matches,2020
580,Mario Šitum,hr CRO,MF,Dinamo Zagreb,27,1992,0.0,0,0,0,0,0,0,0,,0,0,0,0,0,0,0,0,Matches,2020
581,Oliver Skipp,eng ENG,MF,Tottenham,18,2000,0.3,1,0,1,0,0,1,1,100.0,0,1,1,0,1,2,0,0,Matches,2020
582,Milan Škoda,cz CZE,"FW,MF",Slavia Prague,33,1986,0.8,0,0,0,0,0,0,0,,0,0,0,0,0,0,0,0,Matches,2020
583,Milan Škriniar,sk SVK,DF,Inter,24,1995,6.0,15,12,9,6,0,8,13,61.5,5,11,7,4,11,26,14,0,Matches,2020
584,Igor Smolnikov,ru RUS,DF,Zenit,30,1988,1.5,1,1,1,0,0,1,2,50.0,1,0,0,0,1,2,4,0,Matches,2020
585,Fyodor Smolov,ru RUS,FW,Loko Moscow,29,1990,2.2,3,1,0,2,1,0,1,0.0,1,2,0,2,2,5,1,0,Matches,2020
586,Eduard Sobol,ua UKR,FW,Club Brugge,24,1995,2.9,10,8,7,2,1,7,7,100.0,0,2,1,1,2,12,4,0,Matches,2020
587,Carlos Soler,es ESP,MF,Valencia,22,1997,4.4,5,2,2,2,1,2,10,20.0,8,4,0,4,1,6,3,0,Matches,2020
588,Manor Solomon,il ISR,"MF,FW",Shakhtar,20,1999,1.5,2,0,1,1,0,0,1,0.0,1,2,0,2,1,3,0,0,Matches,2020
589,Tomáš Souček,cz CZE,MF,Slavia Prague,24,1995,6.0,15,8,7,4,4,7,17,41.2,10,13,3,10,15,30,17,0,Matches,2020
590,Adama Soumaoro,fr FRA,DF,Lille,27,1992,1.0,0,0,0,0,0,0,0,,0,0,0,0,4,4,4,0,Matches,2020
591,Boubakary Soumaré,fr FRA,MF,Lille,20,1999,5.8,6,5,3,3,0,2,7,28.6,5,7,1,6,12,18,9,0,Matches,2020
592,Marco Sportiello,it ITA,GK,Atalanta,27,1992,2.0,0,0,0,0,0,0,0,,0,0,0,0,0,0,1,0,Matches,2020
593,Nicolae Stanciu,ro ROU,MF,Slavia Prague,26,1993,5.1,5,2,3,1,1,3,11,27.3,8,7,0,7,2,7,0,0,Matches,2020
594,Cican Stankovic,at AUT,GK,RB Salzburg,26,1992,3.4,1,1,1,0,0,1,2,50.0,1,0,0,0,0,1,1,0,Matches,2020
595,Taras Stepanenko,ua UKR,MF,Shakhtar,29,1989,6.0,22,14,15,7,0,11,23,47.8,12,6,3,3,7,29,11,1,Matches,2020
596,Raheem Sterling,eng ENG,"FW,MF",Manchester City,24,1994,6.7,6,3,2,3,1,0,8,0.0,8,5,1,4,6,12,4,0,Matches,2020
597,Petar Stojanović,si SVN,"DF,MF",Dinamo Zagreb,23,1995,5.6,13,5,7,4,2,4,10,40.0,6,6,0,6,4,17,10,0,Matches,2020
598,John Stones,eng ENG,DF,Manchester City,25,1994,0.6,0,0,0,0,0,0,0,,0,1,1,0,2,2,0,0,Matches,2020
599,Luis Suárez,uy URU,FW,Barcelona,32,1987,6.3,2,2,0,2,0,1,3,33.3,2,2,0,2,4,6,4,0,Matches,2020
600,Niklas Süle,de GER,DF,Bayern Munich,23,1995,3.7,11,7,8,2,1,5,6,83.3,1,6,4,2,4,15,7,0,Matches,2020
601,Aleksei Sutormin,ru RUS,MF,Zenit,25,1994,0.3,1,1,0,1,0,0,1,0.0,1,1,0,1,1,2,0,0,Matches,2020
602,Wojciech Szczęsny,pl POL,GK,Juventus,29,1990,7.0,0,0,0,0,0,0,0,,0,0,0,0,0,0,2,0,Matches,2020
603,Dominik Szoboszlai,hu HUN,MF,RB Salzburg,18,2000,4.3,7,2,4,1,2,2,10,20.0,8,8,0,8,1,8,4,0,Matches,2020
604,Adel Taarabt,ma MAR,MF,Benfica,30,1989,4.0,4,2,2,1,1,3,9,33.3,6,2,0,2,3,7,6,0,Matches,2020
605,Dušan Tadić,rs SRB,FW,Ajax,30,1988,6.0,5,3,0,4,1,1,5,20.0,4,2,0,2,7,12,1,0,Matches,2020
606,Nicolás Tagliafico,ar ARG,DF,Ajax,26,1992,6.0,27,12,9,13,5,12,20,60.0,8,7,3,4,18,45,17,1,Matches,2020
607,Jonathan Tah,de GER,DF,Leverkusen,23,1996,5.0,5,4,3,2,0,0,1,0.0,1,3,2,1,7,12,19,1,Matches,2020
608,Taison,br BRA,"MF,FW",Shakhtar,31,1988,5.0,5,2,3,2,0,3,9,33.3,6,4,0,4,4,9,1,1,Matches,2020
609,Laco Takács,cz CZE,DF,Slavia Prague,23,1996,1.0,4,2,2,2,0,2,3,66.7,1,2,2,0,5,9,4,1,Matches,2020
610,Adrien Tameze,cm CMR,MF,Atalanta,25,1994,0.1,0,0,0,0,0,0,0,,0,0,0,0,0,0,1,0,Matches,2020
611,Japhet Tanganga,eng ENG,DF,Tottenham,20,1999,1.0,0,0,0,0,0,0,1,0.0,1,2,1,1,0,0,1,0,Matches,2020
612,Percy Tau,za RSA,FW,Club Brugge,25,1994,2.6,2,2,1,1,0,0,2,0.0,2,0,0,0,1,3,1,0,Matches,2020
613,David Tavares,cv CPV,MF,Benfica,20,1999,0.3,0,0,0,0,0,0,0,,0,0,0,0,0,0,0,0,Matches,2020
614,Tomás Tavares,pt POR,DF,Benfica,18,2001,5.0,11,7,9,2,0,8,16,50.0,8,7,1,6,2,13,13,0,Matches,2020
615,Stanislav Tecl,cz CZE,FW,Slavia Prague,28,1990,1.5,1,0,0,1,0,1,3,33.3,2,1,0,1,0,1,0,0,Matches,2020
616,Marc-André ter Stegen,de GER,GK,Barcelona,27,1992,8.0,0,0,0,0,0,0,0,,0,0,0,0,1,1,5,1,Matches,2020
617,Martin Terrier,fr FRA,"FW,MF",Lyon,22,1997,2.7,8,5,0,5,3,3,7,42.9,4,5,0,5,3,11,0,0,Matches,2020
618,Tetê,br BRA,MF,Shakhtar,19,2000,1.7,2,0,1,1,0,2,2,100.0,0,2,0,2,1,3,0,0,Matches,2020
619,Kenny Tete,nl NED,"DF,MF",Lyon,23,1995,1.6,3,2,1,0,2,0,1,0.0,1,5,3,2,2,5,8,0,Matches,2020
620,Kévin Théophile-Catherine,fr FRA,DF,Dinamo Zagreb,29,1989,4.8,7,4,7,0,0,4,5,80.0,1,8,1,7,9,16,19,0,Matches,2020
621,Jean-Clair Todibo,fr FRA,DF,Barcelona,19,1999,1.0,8,6,7,0,1,5,5,100.0,0,1,1,0,1,9,4,0,Matches,2020
622,Karl Toko Ekambi,cm CMR,FW,Lyon,26,1992,3.1,1,1,0,1,0,1,2,50.0,1,2,0,2,0,1,2,0,Matches,2020
623,Corentin Tolisso,fr FRA,MF,Bayern Munich,24,1994,3.8,4,1,0,2,2,2,5,40.0,3,6,0,6,2,6,1,1,Matches,2020
624,Rafael Tolói,it ITA,DF,Atalanta,28,1990,7.0,19,6,13,5,1,12,25,48.0,13,6,2,4,9,28,13,0,Matches,2020
625,Tomané,pt POR,FW,Red Star,26,1992,2.3,0,0,0,0,0,0,4,0.0,4,0,0,0,0,0,2,0,Matches,2020
626,Raúl de Tomás,es ESP,"FW,MF",Benfica,24,1994,1.4,0,0,0,0,0,0,0,,0,1,0,1,0,0,4,0,Matches,2020
627,Fikayo Tomori,eng ENG,DF,Chelsea,21,1997,4.0,13,7,9,2,2,5,7,71.4,2,4,1,3,6,19,12,0,Matches,2020
628,Vasilis Torosidis,gr GRE,DF,Olympiacos,34,1985,1.0,2,2,2,0,0,2,2,100.0,0,0,0,0,0,2,2,0,Matches,2020
629,Ferrán Torres,es ESP,MF,Valencia,19,2000,5.3,8,5,1,7,0,4,12,33.3,8,10,0,10,5,13,5,0,Matches,2020
630,Lucas Tousart,fr FRA,MF,Lyon,22,1997,6.7,21,11,8,12,1,5,15,33.3,10,13,2,11,8,29,9,0,Matches,2020
631,Bertrand Traoré,bf BFA,"FW,MF",Lyon,23,1995,2.6,2,1,2,0,0,1,3,33.3,2,3,0,3,1,3,5,0,Matches,2020
632,Ibrahim Traoré,ci CIV,"MF,FW",Slavia Prague,30,1988,1.9,2,0,2,0,0,1,6,16.7,5,2,0,2,3,5,2,1,Matches,2020
633,Kieran Trippier,eng ENG,DF,Atlético Madrid,28,1990,6.0,9,6,5,3,1,6,10,60.0,4,8,3,5,7,16,16,0,Matches,2020
634,Kostas Tsimikas,gr GRE,DF,Olympiacos,23,1996,6.0,17,10,13,4,0,10,15,66.7,5,6,3,3,12,29,25,1,Matches,2020
635,Andreas Ulmer,at AUT,DF,RB Salzburg,33,1985,6.0,19,12,10,7,2,13,18,72.2,5,5,0,5,6,25,6,0,Matches,2020
636,Samuel Umtiti,fr FRA,DF,Barcelona,25,1993,3.0,1,1,0,1,0,0,3,0.0,3,4,3,1,5,6,6,0,Matches,2020
637,Dayot Upamecano,fr FRA,DF,RB Leipzig,20,1998,7.3,25,14,17,8,0,9,11,81.8,2,7,4,3,12,37,29,0,Matches,2020
638,Jere Uronen,fi FIN,DF,Genk,25,1994,3.0,5,5,5,0,0,3,4,75.0,1,2,0,2,4,9,7,0,Matches,2020
639,Mathieu Valbuena,fr FRA,MF,Olympiacos,34,1984,1.2,2,1,1,1,0,0,0,,0,0,0,0,1,3,0,0,Matches,2020
640,Borja Valero,es ESP,MF,Inter,34,1985,1.7,3,2,1,2,0,0,1,0.0,1,2,1,1,2,5,2,2,Matches,2020
641,Albert Vallci,at AUT,DF,RB Salzburg,24,1995,0.0,0,0,0,0,0,0,0,,0,1,1,0,0,0,1,0,Matches,2020
642,Manu Vallejo,es ESP,"FW,MF",Valencia,22,1997,0.8,2,2,0,2,0,2,2,100.0,0,3,0,3,0,2,2,0,Matches,2020
643,Federico Valverde,uy URU,MF,Real Madrid,21,1998,3.9,8,5,2,3,3,3,15,20.0,12,8,1,7,7,15,3,0,Matches,2020
644,Virgil van Dijk,nl NED,DF,Liverpool,28,1991,8.3,9,5,6,3,0,2,3,66.7,1,2,1,1,9,18,32,1,Matches,2020
645,Hans Vanaken,be BEL,MF,Club Brugge,26,1992,6.0,5,2,2,3,0,2,16,12.5,14,7,2,5,1,6,5,0,Matches,2020
646,Maarten Vandevoordt,be BEL,GK,Genk,17,2002,1.0,0,0,0,0,0,0,0,,0,0,0,0,1,1,0,1,Matches,2020
647,Raphaël Varane,fr FRA,DF,Real Madrid,26,1993,8.0,9,6,5,4,0,3,7,42.9,4,6,5,1,10,19,22,3,Matches,2020
648,Lucas Vázquez,es ESP,"FW,MF",Real Madrid,28,1991,1.1,0,0,0,0,0,0,4,0.0,4,2,0,2,1,1,0,0,Matches,2020
649,Matías Vecino,uy URU,MF,Inter,27,1991,2.6,7,2,4,2,1,2,6,33.3,4,3,0,3,7,14,4,0,Matches,2020
650,Joël Veltman,nl NED,DF,Ajax,27,1992,4.7,15,4,8,7,0,4,7,57.1,3,5,3,2,11,26,21,1,Matches,2020
651,Marco Verratti,it ITA,MF,Paris S-G,26,1992,6.5,22,12,14,7,1,7,20,35.0,13,7,1,6,4,26,5,0,Matches,2020
652,Jan Vertonghen,be BEL,DF,Tottenham,32,1987,2.8,3,2,2,1,0,0,2,0.0,2,4,4,0,1,4,15,1,Matches,2020
653,Arturo Vidal,cl CHI,"MF,FW",Barcelona,32,1987,4.7,11,7,2,5,4,4,10,40.0,6,3,0,3,2,13,4,0,Matches,2020
654,Carlos Vinícius,br BRA,FW,Benfica,24,1995,3.6,1,1,0,1,0,1,3,33.3,2,1,0,1,0,1,1,0,Matches,2020
655,Vitolo,es ESP,"FW,MF",Atlético Madrid,29,1989,1.3,1,0,0,1,0,0,1,0.0,1,3,0,3,1,2,1,0,Matches,2020
656,Odisseas Vlachodimos,gr GRE,GK,Benfica,25,1994,6.0,0,0,0,0,0,0,1,0.0,1,0,0,0,2,2,6,0,Matches,2020
657,Thibault Vlietinck,be BEL,FW,Club Brugge,21,1997,0.8,1,1,0,0,1,1,2,50.0,1,1,0,1,1,2,0,0,Matches,2020
658,Kevin Volland,de GER,FW,Leverkusen,27,1992,5.1,3,1,1,2,0,0,4,0.0,4,2,1,1,2,5,2,0,Matches,2020
659,Ruud Vormer,nl NED,MF,Club Brugge,31,1988,2.9,5,4,3,2,0,2,7,28.6,5,4,2,2,2,7,2,0,Matches,2020
660,Stefan de Vrij,nl NED,DF,Inter,27,1992,6.0,11,5,7,4,0,4,6,66.7,2,6,3,3,15,26,25,0,Matches,2020
661,Šime Vrsaljko,hr CRO,DF,Atlético Madrid,27,1992,1.3,1,0,0,0,1,0,2,0.0,2,0,0,0,2,3,7,0,Matches,2020
662,Aleksa Vukanović,rs SRB,"MF,FW",Red Star,27,1992,1.9,5,3,1,2,2,2,5,40.0,3,3,1,2,5,10,3,0,Matches,2020
663,Miloš Vulić,rs SRB,MF,Red Star,22,1996,2.1,3,0,2,1,0,1,3,33.3,2,0,0,0,3,6,1,0,Matches,2020
664,Moussa Wagué,sn SEN,FW,Barcelona,20,1998,1.0,4,3,2,2,0,3,3,100.0,0,0,0,0,1,5,5,0,Matches,2020
665,Kyle Walker,eng ENG,DF,Manchester City,29,1990,4.9,8,4,2,4,2,4,5,80.0,1,2,1,1,8,16,6,1,Matches,2020
666,Kyle Walker-Peters,eng ENG,DF,Tottenham,22,1997,1.0,1,1,1,0,0,0,2,0.0,2,2,1,1,0,1,3,0,Matches,2020
667,Victor Wanyama,ke KEN,MF,Tottenham,28,1991,0.1,0,0,0,0,0,0,1,0.0,1,1,0,1,1,1,0,0,Matches,2020
668,Daniel Wass,dk DEN,"DF,MF",Valencia,30,1989,8.0,11,7,6,5,0,10,18,55.6,8,8,1,7,14,25,20,2,Matches,2020
669,Julian Weigl,de GER,"MF,DF",Dortmund,23,1995,3.8,11,5,6,5,0,7,13,53.8,6,6,2,4,3,14,6,0,Matches,2020
670,Mitchell Weiser,de GER,DF,Leverkusen,25,1994,3.0,7,5,7,0,0,3,7,42.9,4,4,0,4,5,12,6,0,Matches,2020
671,Wendell,br BRA,DF,Leverkusen,26,1993,3.9,14,10,8,6,0,8,8,100.0,0,7,2,5,4,18,5,1,Matches,2020
672,Timo Werner,de GER,"FW,MF",RB Leipzig,23,1996,6.4,5,3,1,3,1,2,9,22.2,7,2,0,2,1,6,3,0,Matches,2020
673,Georginio Wijnaldum,nl NED,MF,Liverpool,28,1990,6.1,7,4,5,2,0,0,2,0.0,2,6,0,6,5,12,1,0,Matches,2020
674,Willian,br BRA,"FW,MF",Chelsea,30,1988,5.9,5,2,1,4,0,2,8,25.0,6,6,0,6,0,5,1,0,Matches,2020
675,Harry Winks,eng ENG,MF,Tottenham,23,1996,4.9,12,8,4,6,2,2,9,22.2,7,5,2,3,8,20,8,2,Matches,2020
676,Axel Witsel,be BEL,MF,Dortmund,30,1989,6.8,13,9,7,5,1,5,11,45.5,6,7,2,5,8,21,6,0,Matches,2020
677,Maximilian Wöber,at AUT,DF,RB Salzburg,21,1998,6.0,9,6,4,5,0,7,9,77.8,2,9,9,0,18,27,44,1,Matches,2020
678,Xeka,pt POR,MF,Lille,24,1994,1.3,5,3,2,2,1,2,8,25.0,6,1,0,1,3,8,0,0,Matches,2020
679,Erencan Yardimci,tr TUR,MF,Galatasaray,17,2002,0.0,0,0,0,0,0,0,0,,0,0,0,0,0,0,0,0,Matches,2020
680,Yusuf Yazıcı,tr TUR,"FW,MF",Lille,22,1997,4.1,11,6,4,6,1,4,16,25.0,12,2,0,2,3,14,1,0,Matches,2020
681,Amin Younes,de GER,FW,Napoli,25,1993,0.1,0,0,0,0,0,0,0,,0,0,0,0,0,0,1,0,Matches,2020
682,Abdulla Yusuf Helal,bh BHR,FW,Slavia Prague,26,1993,0.4,1,1,0,1,0,0,1,0.0,1,0,0,0,0,1,0,0,Matches,2020
683,Dan-Axel Zagadou,fr FRA,DF,Dortmund,20,1999,3.2,4,3,3,1,0,1,4,25.0,3,2,1,1,3,7,10,0,Matches,2020
684,Duván Zapata,co COL,FW,Atalanta,28,1991,3.6,0,0,0,0,0,0,2,0.0,2,4,2,2,0,0,4,0,Matches,2020
685,Jaroslav Zelený,cz CZE,"MF,FW",Slavia Prague,26,1992,1.2,0,0,0,0,0,0,2,0.0,2,0,0,0,1,1,0,0,Matches,2020
686,Rifat Zhemaletdinov,ru RUS,"MF,FW",Loko Moscow,22,1996,4.0,6,2,5,1,0,4,14,28.6,10,3,0,3,2,8,7,1,Matches,2020
687,Yuri Zhirkov,ru RUS,"DF,MF",Zenit,35,1983,0.8,3,1,3,0,0,1,1,100.0,0,0,0,0,0,3,0,0,Matches,2020
688,Piotr Zieliński,pl POL,MF,Napoli,25,1994,5.8,5,4,2,2,1,3,6,50.0,3,4,1,3,5,10,4,0,Matches,2020
689,Oleksandr Zinchenko,ua UKR,"DF,MF",Manchester City,22,1996,1.3,2,0,0,2,0,2,4,50.0,2,0,0,0,3,5,2,0,Matches,2020
690,Joshua Zirkzee,nl NED,FW,Bayern Munich,18,2001,0.1,0,0,0,0,0,0,1,0.0,1,0,0,0,0,0,0,0,Matches,2020
691,Hakim Ziyech,ma MAR,"FW,MF",Ajax,26,1993,5.5,14,9,4,3,7,3,23,13.0,20,2,0,2,2,16,2,0,Matches,2020
692,Kurt Zouma,fr FRA,DF,Chelsea,24,1994,6.8,6,5,5,1,0,1,2,50.0,1,7,3,4,5,11,28,0,Matches,2020
693,Marko Đira,hr CRO,"MF,FW",Dinamo Zagreb,20,1999,0.7,0,0,0,0,0,0,0,,0,0,0,0,1,1,0,0,Matches,2020
1,Vincent Aboubakar,cm CMR,FW,Porto,26,1992,0.7,0,0,0,0,0,0,0,,0,0,0,0,0,0,2,0,Matches,2019
2,Michel Aebischer,ch SUI,MF,Young Boys,21,1997,2.5,9,5,3,6,0,6,12,50.0,6,5,1,4,1,10,3,0,Matches,2019
3,Sergio Agüero,ar ARG,FW,Manchester City,30,1988,5.6,4,3,0,2,2,0,6,0.0,6,2,0,2,2,6,1,0,Matches,2019
4,Jean-Eudes Aholou,ci CIV,"MF,FW",Monaco,24,1994,2.0,2,0,1,1,0,0,2,0.0,2,2,0,2,3,5,1,1,Matches,2019
5,Youssef Aït Bennasser,ma MAR,MF,Monaco,22,1996,2.7,5,2,2,3,0,2,8,25.0,6,3,0,3,0,5,10,0,Matches,2019
6,Manuel Akanji,ch SUI,DF,Dortmund,23,1995,5.0,13,7,8,4,1,4,5,80.0,1,3,1,2,9,22,15,0,Matches,2019
7,Emre Akbaba,tr TUR,FW,Galatasaray,25,1992,1.0,2,1,2,0,0,0,1,0.0,1,1,0,1,1,3,0,0,Matches,2019
8,Yunus Akgün,tr TUR,MF,Galatasaray,18,2000,0.1,0,0,0,0,0,0,0,,0,0,0,0,0,0,0,0,Matches,2019
9,Ilzat Akhmetov,ru RUS,MF,CSKA Moscow,20,1997,3.3,12,6,7,4,1,4,6,66.7,2,4,1,3,3,15,4,0,Matches,2019
10,Igor Akinfeev,ru RUS,GK,CSKA Moscow,32,1986,5.0,0,0,0,0,0,0,0,,0,0,0,0,0,0,0,1,Matches,2019
11,Kevin Akpoguma,ng NGA,DF,Hoffenheim,23,1995,2.0,7,4,6,1,0,3,4,75.0,1,4,2,2,1,8,3,1,Matches,2019
12,David Alaba,at AUT,DF,Bayern Munich,26,1992,7.0,9,6,1,7,1,4,13,30.8,9,8,3,5,16,25,23,1,Matches,2019
13,Jordi Alba,es ESP,DF,Barcelona,29,1989,11.0,11,8,6,4,1,5,13,38.5,8,11,5,6,17,28,30,2,Matches,2019
14,Raúl Albiol,es ESP,DF,Napoli,32,1985,5.5,2,1,1,1,0,0,0,,0,5,5,0,8,10,29,0,Matches,2019
15,Paco Alcácer,es ESP,FW,Dortmund,24,1993,4.0,2,2,0,2,0,0,2,0.0,2,3,0,3,3,5,1,0,Matches,2019
16,Thiago Alcántara,es ESP,MF,Bayern Munich,27,1991,4.3,9,6,4,4,1,1,5,20.0,4,6,1,5,10,19,3,0,Matches,2019
17,Toby Alderweireld,be BEL,DF,Tottenham,29,1989,12.0,11,7,11,0,0,6,15,40.0,9,17,12,5,12,23,44,2,Matches,2019
18,Alef,br BRA,MF,AEK Athens,23,1995,2.2,5,2,4,1,0,3,5,60.0,2,3,0,3,7,12,3,0,Matches,2019
19,Carles Aleñá,es ESP,MF,Barcelona,20,1998,1.0,2,2,2,0,0,0,3,0.0,3,0,0,0,0,2,1,0,Matches,2019
20,Trent Alexander-Arnold,eng ENG,DF,Liverpool,19,1998,10.2,21,10,11,6,4,13,19,68.4,6,8,1,7,18,39,22,1,Matches,2019
21,Alisson,br BRA,GK,Liverpool,25,1992,13.0,0,0,0,0,0,0,0,,0,0,0,0,1,1,2,1,Matches,2019
22,Allan,br BRA,MF,Napoli,27,1991,5.7,39,22,15,24,0,11,34,32.4,23,6,0,6,5,44,4,1,Matches,2019
23,Dele Alli,eng ENG,MF,Tottenham,22,1996,7.9,9,5,3,4,2,3,11,27.3,8,5,1,4,6,15,7,0,Matches,2019
24,André Almeida,pt POR,DF,Benfica,27,1990,6.0,16,11,10,6,0,6,13,46.2,7,15,3,12,14,30,22,0,Matches,2019
25,Dani Alves,br BRA,"FW,DF",Paris S-G,35,1983,2.3,4,4,3,1,0,1,4,25.0,3,6,1,5,3,7,1,0,Matches,2019
26,Mohamed Aly Camara,gn GUI,DF,Young Boys,20,1997,3.9,7,3,6,1,0,5,6,83.3,1,7,6,1,10,17,17,0,Matches,2019
27,Nadiem Amiri,de GER,MF,Hoffenheim,21,1996,0.3,3,1,3,0,0,1,2,50.0,1,0,0,0,1,4,0,0,Matches,2019
28,Sofyan Amrabat,ma MAR,"DF,MF",Club Brugge,21,1996,2.0,4,2,3,1,0,4,5,80.0,1,6,1,5,4,8,6,0,Matches,2019
29,Angeliño,es ESP,DF,PSV Eindhoven,21,1997,6.0,7,4,4,2,1,5,9,55.6,4,11,7,4,10,17,26,0,Matches,2019
30,Houssem Aouar,dz ALG,"MF,FW",Lyon,20,1998,7.0,17,8,9,8,0,6,17,35.3,11,8,4,4,7,24,13,0,Matches,2019
31,Alphonse Areola,fr FRA,GK,Paris S-G,25,1993,3.0,0,0,0,0,0,0,0,,0,0,0,0,0,0,2,0,Matches,2019
32,Santiago Arias,co COL,"DF,FW",Atlético Madrid,26,1992,3.8,9,5,9,0,0,5,8,62.5,3,0,0,0,2,11,17,0,Matches,2019
33,Kwadwo Asamoah,gh GHA,DF,Inter,29,1988,5.8,8,5,4,4,0,1,3,33.3,2,6,2,4,8,16,18,2,Matches,2019
34,Marco Asensio,es ESP,"FW,MF",Real Madrid,22,1996,3.4,2,2,1,1,0,0,2,0.0,2,0,0,0,5,7,1,0,Matches,2019
35,Roger Assalé,ci CIV,"FW,MF",Young Boys,24,1993,4.2,2,2,0,1,1,1,4,25.0,3,4,0,4,2,4,0,1,Matches,2019
36,Serge Aurier,ci CIV,DF,Tottenham,25,1992,4.8,8,6,4,4,0,1,7,14.3,6,8,1,7,9,17,14,0,Matches,2019
37,Chidozie Awaziem,ng NGA,MF,Porto,21,1997,0.1,0,0,0,0,0,0,0,,0,0,0,0,0,0,0,0,Matches,2019
38,Serdar Aziz,tr TUR,DF,Galatasaray,27,1990,4.0,7,4,6,1,0,3,4,75.0,1,3,2,1,3,10,24,0,Matches,2019
39,Srđan Babić,rs SRB,DF,Red Star,22,1996,2.5,1,1,1,0,0,1,3,33.3,2,2,0,2,5,6,11,1,Matches,2019
40,Benoît Badiashile,fr FRA,DF,Monaco,17,2001,2.0,2,2,2,0,0,2,2,100.0,0,4,2,2,0,2,10,1,Matches,2019
41,Loic Badiashile,fr FRA,GK,Monaco,20,1998,1.0,0,0,0,0,0,0,0,,0,0,0,0,0,0,2,0,Matches,2019
42,Eric Bailly,ci CIV,DF,Manchester Utd,24,1994,3.4,5,3,1,4,0,3,5,60.0,2,2,0,2,5,10,18,0,Matches,2019
43,Michalis Bakakis,gr GRE,"DF,FW",AEK Athens,27,1991,5.8,10,8,3,5,2,4,11,36.4,7,4,1,3,13,23,23,0,Matches,2019
44,Anastasios Bakasetas,gr GRE,FW,AEK Athens,25,1993,2.0,9,8,6,1,2,1,3,33.3,2,3,0,3,1,10,1,0,Matches,2019
45,Keita Baldé,sn SEN,"FW,MF",Inter,23,1995,0.8,1,0,1,0,0,0,0,,0,0,0,0,0,1,0,0,Matches,2019
46,Gareth Bale,wls WAL,FW,Real Madrid,29,1989,5.4,2,0,1,1,0,1,5,20.0,4,2,0,2,5,7,2,0,Matches,2019
47,David von Ballmoos,ch SUI,GK,Young Boys,23,1994,4.0,0,0,0,0,0,0,0,,0,0,0,0,0,0,1,1,Matches,2019
48,Dmitri Barinov,ru RUS,MF,Loko Moscow,21,1996,3.2,9,4,5,2,2,3,8,37.5,5,7,2,5,10,19,9,0,Matches,2019
49,Vasilios Barkas,gr GRE,GK,AEK Athens,24,1994,6.0,0,0,0,0,0,0,0,,0,0,0,0,0,0,0,1,Matches,2019
50,Antonio Barreca,it ITA,DF,Monaco,23,1995,1.0,0,0,0,0,0,0,0,,0,0,0,0,0,0,0,0,Matches,2019
51,Andrea Barzagli,it ITA,DF,Juventus,37,1981,1.2,2,1,1,1,0,2,3,66.7,1,0,0,0,1,3,2,0,Matches,2019
52,Michy Batshuayi,be BEL,FW,Valencia,24,1993,3.8,3,2,0,2,1,0,1,0.0,1,3,0,3,1,4,1,0,Matches,2019
53,Oliver Baumann,de GER,GK,Hoffenheim,28,1990,6.0,0,0,0,0,0,0,1,0.0,1,0,0,0,0,0,2,0,Matches,2019
54,Ömer Bayram,tr TUR,DF,Galatasaray,27,1991,0.6,3,1,2,1,0,1,2,50.0,1,0,0,0,0,3,0,0,Matches,2019
55,Riechedly Bazoer,nl NED,MF,Porto,21,1996,0.1,0,0,0,0,0,0,0,,0,0,0,0,0,0,0,0,Matches,2019
56,Rodrigo Becão,br BRA,DF,CSKA Moscow,22,1996,6.0,11,8,9,1,1,5,12,41.7,7,9,6,3,10,21,25,0,Matches,2019
57,Donny van de Beek,nl NED,MF,Ajax,21,1997,10.9,26,17,4,17,5,8,16,50.0,8,14,1,13,14,40,8,0,Matches,2019
58,Ishak Belfodil,dz ALG,"FW,MF",Hoffenheim,26,1992,3.8,5,4,2,1,2,2,3,66.7,1,1,0,1,1,6,1,0,Matches,2019
59,Younès Belhanda,ma MAR,MF,Galatasaray,28,1990,3.6,6,5,0,6,0,0,5,0.0,5,6,1,5,2,8,1,0,Matches,2019
60,Diego Benaglio,ch SUI,GK,Monaco,34,1983,4.5,0,0,0,0,0,0,0,,0,0,0,0,1,1,0,0,Matches,2019
61,Medhi Benatia,ma MAR,DF,Juventus,31,1987,1.0,2,2,2,0,0,1,1,100.0,0,0,0,0,2,4,2,0,Matches,2019
62,Loris Benito,ch SUI,DF,Young Boys,26,1992,6.0,11,7,4,2,5,0,4,0.0,4,8,1,7,7,18,23,0,Matches,2019
63,Nabil Bentaleb,dz ALG,MF,Schalke 04,23,1994,4.7,18,8,8,9,1,5,13,38.5,8,4,2,2,5,23,8,0,Matches,2019
64,Rodrigo Bentancur,uy URU,MF,Juventus,21,1997,6.1,15,11,8,6,1,2,9,22.2,7,10,2,8,9,24,7,1,Matches,2019
65,Karim Benzema,fr FRA,FW,Real Madrid,30,1987,6.5,2,2,0,1,1,0,1,0.0,1,1,0,1,2,4,8,0,Matches,2019
66,Steve von Bergen,ch SUI,DF,Young Boys,35,1983,4.5,7,7,2,4,1,2,3,66.7,1,4,3,1,10,17,17,0,Matches,2019
67,Steven Bergwijn,nl NED,FW,PSV Eindhoven,20,1997,4.4,4,3,1,2,1,2,5,40.0,3,1,0,1,3,7,2,0,Matches,2019
68,Federico Bernardeschi,it ITA,"MF,FW",Juventus,24,1994,6.1,4,2,2,1,1,3,3,100.0,0,9,0,9,5,9,6,0,Matches,2019
69,Juan Bernat,es ESP,DF,Paris S-G,25,1993,7.5,12,8,5,7,0,3,8,37.5,5,4,1,3,10,22,24,0,Matches,2019
70,Leonardo Bertone,ch SUI,MF,Young Boys,24,1994,1.2,1,0,0,1,0,1,3,33.3,2,1,1,0,1,2,6,0,Matches,2019
71,Giulian Biancone,fr FRA,DF,Monaco,18,2000,1.9,3,2,3,0,0,2,4,50.0,2,5,1,4,3,6,6,0,Matches,2019
72,Ermin Bičakčić,ba BIH,DF,Hoffenheim,28,1990,2.8,6,4,6,0,0,5,9,55.6,4,2,2,0,5,11,4,0,Matches,2019
73,Jaka Bijol,si SVN,MF,CSKA Moscow,19,1999,3.0,9,6,6,3,0,3,8,37.5,5,3,0,3,4,13,10,0,Matches,2019
74,Kristijan Bistrović,hr CRO,MF,CSKA Moscow,20,1998,2.0,1,1,1,0,0,1,5,20.0,4,2,0,2,0,1,3,0,Matches,2019
75,Leonardo Bittencourt,de GER,MF,Hoffenheim,24,1993,1.6,7,6,3,2,2,3,9,33.3,6,3,0,3,3,10,0,0,Matches,2019
76,Daley Blind,nl NED,"DF,MF",Ajax,28,1990,12.0,23,11,12,9,2,9,19,47.4,10,22,10,12,20,43,45,0,Matches,2019
77,Richmond Boakye,gh GHA,FW,Red Star,25,1993,2.1,0,0,0,0,0,0,1,0.0,1,2,0,2,1,1,3,0,Matches,2019
78,Jérôme Boateng,de GER,DF,Bayern Munich,29,1988,5.0,7,5,1,4,2,4,5,80.0,1,4,3,1,10,17,17,0,Matches,2019
79,Serhiy Bolbat,ua UKR,FW,Shakhtar,25,1993,1.9,1,1,1,0,0,0,1,0.0,1,0,0,0,2,3,1,0,Matches,2019
80,Leonardo Bonucci,it ITA,DF,Juventus,31,1987,10.0,7,5,4,2,1,2,5,40.0,3,11,9,2,12,19,27,0,Matches,2019
81,Milan Borjan,ca CAN,GK,Red Star,30,1987,6.0,0,0,0,0,0,0,0,,0,0,0,0,1,1,0,1,Matches,2019
82,Lucas Boyé,ar ARG,"FW,MF",AEK Athens,22,1996,1.4,2,1,2,0,0,1,5,20.0,4,1,0,1,2,4,1,0,Matches,2019
83,Yacine Brahimi,dz ALG,"FW,MF",Porto,28,1990,6.9,8,6,6,0,2,2,7,28.6,5,5,0,5,6,14,2,0,Matches,2019
84,Joshua Brenet,nl NED,"DF,FW",Hoffenheim,24,1994,1.5,4,1,2,2,0,2,5,40.0,3,0,0,0,0,4,4,0,Matches,2019
85,Marcelo Brozović,hr CRO,MF,Inter,25,1992,5.9,17,7,12,5,0,2,12,16.7,10,10,2,8,9,26,6,0,Matches,2019
86,Jeffrey Bruma,nl NED,DF,Schalke 04,26,1991,2.0,2,1,1,1,0,0,1,0.0,1,4,2,2,1,3,5,0,Matches,2019
87,Jacob Bruun Larsen,dk DEN,FW,Dortmund,19,1998,1.7,2,1,0,2,0,0,3,0.0,3,0,0,0,3,5,1,0,Matches,2019
88,Gianluigi Buffon,it ITA,GK,Paris S-G,40,1978,5.0,0,0,0,0,0,0,1,0.0,1,0,0,0,1,1,1,1,Matches,2019
89,Guido Burgstaller,at AUT,FW,Schalke 04,29,1989,2.6,0,0,0,0,0,0,2,0.0,2,2,0,2,0,0,0,0,Matches,2019
90,Roman Bürki,ch SUI,GK,Dortmund,27,1990,7.0,0,0,0,0,0,0,0,,0,0,0,0,0,0,2,0,Matches,2019
91,Sergio Busquets,es ESP,MF,Barcelona,30,1988,11.5,41,21,14,25,2,14,31,45.2,17,14,3,11,15,56,11,1,Matches,2019
92,Bohdan Butko,ua UKR,DF,Shakhtar,27,1991,1.5,1,1,0,0,1,1,2,50.0,1,1,0,1,1,2,9,0,Matches,2019
93,Daniel Caligiuri,it ITA,"DF,FW",Schalke 04,30,1988,5.7,20,17,9,9,2,5,20,25.0,15,16,2,14,11,31,18,0,Matches,2019
94,José Callejón,es ESP,MF,Napoli,31,1987,5.7,6,2,2,3,1,2,12,16.7,10,2,0,2,6,12,4,0,Matches,2019
95,Emre Can,de GER,"MF,DF",Juventus,24,1994,3.8,4,1,0,3,1,2,6,33.3,4,5,1,4,8,12,8,0,Matches,2019
96,João Cancelo,pt POR,DF,Juventus,24,1994,5.3,15,10,8,7,0,8,15,53.3,7,3,0,3,6,21,12,0,Matches,2019
97,Antonio Candreva,it ITA,"FW,MF",Inter,31,1987,1.5,0,0,0,0,0,0,2,0.0,2,3,0,3,0,0,4,0,Matches,2019
98,Dani Carvajal,es ESP,DF,Real Madrid,26,1992,4.7,9,6,5,4,0,3,6,50.0,3,4,3,1,8,17,10,2,Matches,2019
99,Casemiro,br BRA,MF,Real Madrid,26,1992,5.6,14,9,8,5,1,5,14,35.7,9,15,6,9,13,27,8,0,Matches,2019
100,Iker Casillas,es ESP,GK,Porto,37,1981,10.3,0,0,0,0,0,0,1,0.0,1,0,0,0,1,1,7,0,Matches,2019
101,Nicolás Castillo,cl CHI,FW,Benfica,25,1993,0.2,0,0,0,0,0,0,2,0.0,2,0,0,0,0,0,0,0,Matches,2019
102,Goran Čaušić,rs SRB,MF,Red Star,26,1992,3.5,8,4,4,4,0,2,4,50.0,2,6,3,3,6,14,9,1,Matches,2019
103,Edinson Cavani,uy URU,FW,Paris S-G,31,1987,4.6,0,0,0,0,0,0,2,0.0,2,3,0,3,4,4,4,0,Matches,2019
104,Dani Ceballos,es ESP,MF,Real Madrid,21,1996,2.1,0,0,0,0,0,0,0,,0,5,0,5,1,1,1,0,Matches,2019
105,Muğdat Çelik,tr TUR,FW,Galatasaray,28,1990,0.5,1,0,0,1,0,1,2,50.0,1,0,0,0,0,1,1,1,Matches,2019
106,Aleš Čermák,cz CZE,MF,Viktoria Plzeň,23,1994,3.9,5,2,1,3,1,1,5,20.0,4,3,0,3,1,6,4,0,Matches,2019
107,Franco Cervi,ar ARG,"FW,MF",Benfica,24,1994,3.4,15,8,7,6,2,7,13,53.8,6,7,0,7,2,17,1,0,Matches,2019
108,Nacer Chadli,be BEL,MF,Monaco,28,1989,3.5,2,1,0,2,0,0,2,0.0,2,5,1,4,3,5,8,0,Matches,2019
109,Fyodor Chalov,ru RUS,FW,CSKA Moscow,20,1998,5.6,4,3,2,1,1,0,4,0.0,4,4,0,4,0,4,3,0,Matches,2019
110,Pape Cheikh Diop,sn SEN,MF,Lyon,20,1997,1.2,5,4,1,3,1,1,4,25.0,3,4,0,4,0,5,2,0,Matches,2019
111,Nikita Chernov,ru RUS,DF,CSKA Moscow,22,1996,3.9,8,4,4,4,0,2,4,50.0,2,5,1,4,4,12,36,0,Matches,2019
112,Denis Cheryshev,ru RUS,"MF,DF",Valencia,27,1990,1.2,3,1,0,3,0,1,6,16.7,5,2,0,2,2,5,0,1,Matches,2019
113,Giorgio Chiellini,it ITA,DF,Juventus,33,1984,6.0,8,6,7,1,0,6,9,66.7,3,8,6,2,10,18,36,1,Matches,2019
114,Tahith Chong,nl NED,MF,Manchester Utd,18,1999,0.1,1,1,1,0,0,0,1,0.0,1,0,0,0,0,1,1,0,Matches,2019
115,Tomáš Chorý,cz CZE,FW,Viktoria Plzeň,23,1995,2.7,3,2,1,2,0,0,2,0.0,2,2,0,2,1,4,3,0,Matches,2019
116,Dmytro Chygrynskiy,ua UKR,DF,AEK Athens,31,1986,5.0,10,8,10,0,0,5,7,71.4,2,12,5,7,8,18,23,0,Matches,2019
117,Jasper Cillessen,nl NED,GK,Barcelona,29,1989,1.0,0,0,0,0,0,0,0,,0,0,0,0,0,0,0,0,Matches,2019
118,Kingsley Coman,fr FRA,"FW,MF",Bayern Munich,22,1996,1.4,1,1,1,0,0,1,5,20.0,4,2,0,2,1,2,0,0,Matches,2019
119,Germán Conti,ar ARG,DF,Benfica,24,1994,3.0,6,6,5,1,0,2,4,50.0,2,5,4,1,11,17,15,1,Matches,2019
120,Dion Cools,my MAS,"DF,FW",Club Brugge,22,1996,1.3,0,0,0,0,0,0,0,,0,1,0,1,1,1,5,0,Matches,2019
121,Francis Coquelin,fr FRA,MF,Valencia,27,1991,3.1,7,5,3,4,0,3,7,42.9,4,1,1,0,10,17,5,0,Matches,2019
122,Ante Ćorić,hr CRO,MF,Roma,21,1997,0.3,0,0,0,0,0,0,0,,0,0,0,0,0,0,0,0,Matches,2019
123,Vedran Ćorluka,hr CRO,DF,Loko Moscow,32,1986,3.0,5,4,3,2,0,3,5,60.0,2,3,3,0,3,8,14,0,Matches,2019
124,Maxwel Cornet,ci CIV,"FW,MF",Lyon,21,1996,2.4,6,2,5,0,1,3,3,100.0,0,2,1,1,1,7,1,0,Matches,2019
125,Jesús Corona,mx MEX,"FW,MF",Porto,25,1993,6.2,15,12,6,6,3,6,10,60.0,4,7,1,6,8,23,1,0,Matches,2019
126,Ángel Correa,ar ARG,"MF,FW",Atlético Madrid,23,1995,3.9,10,6,3,4,3,2,8,25.0,6,5,0,5,6,16,2,0,Matches,2019
127,Uroš Ćosić,rs SRB,"DF,MF",AEK Athens,25,1992,3.3,2,2,1,1,0,0,3,0.0,3,1,1,0,8,10,14,0,Matches,2019
128,Bruno Xavier Almeida Costa,pt POR,MF,Porto,21,1997,0.3,2,2,1,0,1,0,1,0.0,1,1,1,0,0,2,0,0,Matches,2019
129,Diego Costa,es ESP,FW,Atlético Madrid,29,1988,3.4,0,0,0,0,0,0,1,0.0,1,0,0,0,1,1,2,0,Matches,2019
130,Douglas Costa,br BRA,"FW,DF",Juventus,27,1990,1.8,1,1,1,0,0,0,1,0.0,1,3,0,3,1,2,2,0,Matches,2019
131,Thibaut Courtois,be BEL,GK,Real Madrid,26,1992,5.0,0,0,0,0,0,0,0,,0,0,0,0,0,0,2,1,Matches,2019
132,Philippe Coutinho,br BRA,"FW,MF",Barcelona,26,1992,9.5,6,3,1,3,2,5,15,33.3,10,10,1,9,10,16,1,0,Matches,2019
133,Bryan Cristante,it ITA,MF,Roma,23,1995,5.7,16,8,3,11,2,4,15,26.7,11,11,2,9,7,23,6,0,Matches,2019
134,Juan Cuadrado,co COL,"MF,DF",Juventus,30,1988,3.6,10,6,5,2,3,4,10,40.0,6,1,0,1,3,13,1,0,Matches,2019
135,Danilo D'Ambrosio,it ITA,DF,Inter,29,1988,4.0,11,6,6,5,0,3,9,33.3,6,1,0,1,6,17,4,0,Matches,2019
136,Colin Dagba,fr FRA,FW,Paris S-G,19,1998,0.1,1,1,1,0,0,0,0,,0,0,0,0,0,1,0,0,Matches,2019
137,Mahmoud Dahoud,de GER,MF,Dortmund,22,1996,3.5,4,2,1,3,0,2,12,16.7,10,4,0,4,7,11,2,1,Matches,2019
138,Diogo Dalot,pt POR,"DF,MF",Manchester Utd,19,1999,2.7,4,2,1,3,0,1,6,16.7,5,3,1,2,2,6,10,0,Matches,2019
139,Oleh Danchenko,ua UKR,DF,Shakhtar,23,1994,1.0,2,1,1,1,0,1,2,50.0,1,0,0,0,2,4,3,0,Matches,2019
140,Danilo,br BRA,DF,Manchester City,27,1991,1.3,0,0,0,0,0,0,0,,0,1,0,1,2,2,2,0,Matches,2019
141,Arnaut Danjuma,nl NED,"DF,FW",Club Brugge,21,1997,1.8,0,0,0,0,0,0,0,,0,0,0,0,1,1,2,0,Matches,2019
142,Ben Davies,wls WAL,DF,Tottenham,25,1993,6.3,8,4,5,2,1,4,10,40.0,6,11,3,8,10,18,20,0,Matches,2019
143,Kevin De Bruyne,be BEL,MF,Manchester City,27,1991,2.7,3,2,2,0,1,0,5,0.0,5,6,1,5,2,5,1,0,Matches,2019
144,Daniele De Rossi,it ITA,MF,Roma,35,1983,3.4,3,2,2,1,0,2,9,22.2,7,3,2,1,7,10,6,0,Matches,2019
145,Mattia De Sciglio,it ITA,DF,Juventus,25,1992,3.4,4,2,1,1,2,2,3,66.7,1,0,0,0,6,10,6,0,Matches,2019
146,Saulo Decarli,ch SUI,MF,Club Brugge,26,1992,0.0,0,0,0,0,0,0,0,,0,0,0,0,0,0,0,0,Matches,2019
147,Miloš Degenek,au AUS,DF,Red Star,24,1994,6.0,8,4,8,0,0,5,7,71.4,2,10,6,4,13,21,47,0,Matches,2019
148,Thomas Delaney,dk DEN,MF,Dortmund,26,1991,3.3,6,5,3,3,0,3,6,50.0,3,6,2,4,8,14,7,0,Matches,2019
149,Fabian Delph,eng ENG,"DF,MF",Manchester City,28,1989,2.9,2,1,1,1,0,1,6,16.7,5,4,1,3,5,7,4,1,Matches,2019
150,Mousa Dembélé,be BEL,MF,Tottenham,31,1987,1.8,4,0,1,3,0,4,4,100.0,0,3,0,3,2,6,0,0,Matches,2019
151,Moussa Dembélé,fr FRA,FW,Lyon,22,1996,3.3,2,2,0,2,0,0,0,,0,4,1,3,1,3,3,0,Matches,2019
152,Ousmane Dembélé,fr FRA,FW,Barcelona,21,1997,4.6,2,1,0,1,1,1,3,33.3,2,2,0,2,1,3,0,0,Matches,2019
153,Kerem Demirbay,de GER,MF,Hoffenheim,25,1993,4.1,7,4,3,4,0,0,10,0.0,10,7,1,6,4,11,2,0,Matches,2019
154,Jason Denayer,be BEL,DF,Lyon,23,1995,8.0,9,7,8,1,0,5,6,83.3,1,17,8,9,11,20,37,1,Matches,2019
155,Igor Denisov,ru RUS,MF,Loko Moscow,34,1984,5.2,10,6,4,5,1,6,20,30.0,14,5,1,4,8,18,5,0,Matches,2019
156,Emmanuel Dennis,ng NGA,"FW,MF",Club Brugge,20,1997,2.0,3,2,2,0,1,1,3,33.3,2,2,0,2,4,7,4,0,Matches,2019
157,Stefano Denswil,nl NED,DF,Club Brugge,25,1993,6.0,5,4,1,4,0,2,4,50.0,2,3,2,1,9,14,18,0,Matches,2019
158,Dentinho,br BRA,"MF,FW",Shakhtar,29,1989,0.1,1,0,1,0,0,0,1,0.0,1,0,0,0,0,1,0,0,Matches,2019
159,Eren Derdiyok,ch SUI,FW,Galatasaray,30,1988,3.7,1,1,1,0,0,0,0,,0,6,1,5,1,2,4,0,Matches,2019
160,Ángel Di María,ar ARG,"MF,FW",Paris S-G,30,1988,7.3,6,4,4,2,0,2,11,18.2,9,5,1,4,6,12,6,1,Matches,2019
161,Franco Di Santo,ar ARG,FW,Schalke 04,29,1989,1.0,1,1,0,0,1,1,1,100.0,0,0,0,0,0,1,1,0,Matches,2019
162,Moussa Diaby,fr FRA,DF,Paris S-G,19,1999,0.1,1,0,0,1,0,0,0,,0,0,0,0,0,1,0,0,Matches,2019
163,Mouctar Diakhaby,gn GUI,DF,Valencia,21,1996,3.0,8,5,7,0,1,3,3,100.0,0,4,3,1,5,13,12,0,Matches,2019
164,Abdou Diallo,sn SEN,DF,Dortmund,22,1996,6.9,12,8,5,6,1,5,7,71.4,2,10,5,5,8,20,21,0,Matches,2019
165,Rúben Dias,pt POR,DF,Benfica,21,1997,4.5,7,6,3,4,0,4,5,80.0,1,4,3,1,8,15,17,1,Matches,2019
166,Krépin Diatta,sn SEN,"DF,FW",Club Brugge,19,1999,0.1,0,0,0,0,0,0,0,,0,0,0,0,0,0,0,0,Matches,2019
167,Eric Dier,eng ENG,MF,Tottenham,24,1994,3.0,3,3,1,1,1,2,4,50.0,2,5,1,4,4,7,9,0,Matches,2019
168,Sofiane Diop,fr FRA,"FW,MF",Monaco,18,2000,3.0,2,0,0,2,0,1,5,20.0,4,2,0,2,1,3,0,0,Matches,2019
169,Kasper Dolberg,dk DEN,FW,Ajax,20,1997,3.3,4,3,0,4,0,1,5,20.0,4,0,0,0,2,6,0,0,Matches,2019
170,Jaume Doménech,es ESP,GK,Valencia,27,1990,1.0,0,0,0,0,0,0,0,,0,0,0,0,0,0,1,0,Matches,2019
171,Ryan Donk,sr SUR,"MF,DF",Galatasaray,32,1986,5.2,8,5,5,3,0,2,6,33.3,4,6,4,2,7,15,18,0,Matches,2019
172,Julian Draxler,de GER,MF,Paris S-G,24,1993,3.2,4,4,1,1,2,1,5,20.0,4,1,0,1,1,5,1,0,Matches,2019
173,Leo Dubois,fr FRA,DF,Lyon,23,1994,3.2,2,0,1,1,0,1,4,25.0,3,6,3,3,6,8,10,0,Matches,2019
174,Denzel Dumfries,nl NED,DF,PSV Eindhoven,22,1996,6.0,9,5,8,1,0,5,12,41.7,7,13,7,6,8,17,37,0,Matches,2019
175,Paulo Dybala,ar ARG,"FW,MF",Juventus,24,1993,5.8,6,3,0,4,2,1,4,25.0,3,9,0,9,2,8,2,1,Matches,2019
176,Alan Dzagoev,ru RUS,"MF,FW",CSKA Moscow,28,1990,1.9,0,0,0,0,0,0,2,0.0,2,1,0,1,1,1,2,0,Matches,2019
177,Edin Džeko,ba BIH,FW,Roma,32,1986,6.3,2,1,1,0,1,0,3,0.0,3,2,0,2,0,2,8,0,Matches,2019
178,Lorenzo Ebecilio,nl NED,"MF,FW",Red Star,26,1991,1.3,3,1,0,2,1,1,4,25.0,3,2,1,1,3,6,0,0,Matches,2019
179,Éder,pt POR,FW,Loko Moscow,30,1987,3.4,3,2,1,2,0,1,1,100.0,0,2,0,2,0,3,0,0,Matches,2019
180,Ederson,br BRA,GK,Manchester City,24,1993,10.0,0,0,0,0,0,0,0,,0,0,0,0,2,2,1,1,Matches,2019
181,Carel Eiting,nl NED,MF,Ajax,20,1998,1.0,1,0,0,1,0,1,1,100.0,0,2,0,2,2,3,1,0,Matches,2019
182,Jurgen Ekkelenkamp,nl NED,MF,Ajax,18,2000,0.2,0,0,0,0,0,0,1,0.0,1,0,0,0,0,0,0,0,Matches,2019
183,Breel Embolo,ch SUI,"FW,MF",Schalke 04,21,1997,4.2,4,2,0,4,0,0,4,0.0,4,5,0,5,1,5,0,0,Matches,2019
184,Christian Eriksen,dk DEN,"MF,FW",Tottenham,26,1992,11.1,9,5,2,3,4,4,9,44.4,5,14,2,12,12,21,10,0,Matches,2019
185,Fabinho,br BRA,"MF,DF",Liverpool,24,1993,8.1,27,21,9,17,1,12,34,35.3,22,5,0,5,12,39,15,0,Matches,2019
186,Ralf Fährmann,de GER,GK,Schalke 04,29,1988,6.0,0,0,0,0,0,0,1,0.0,1,0,0,0,0,0,1,2,Matches,2019
187,Radamel Falcao,co COL,FW,Monaco,32,1986,3.8,2,2,0,1,1,0,2,0.0,2,1,0,1,0,2,2,0,Matches,2019
188,Jefferson Farfán,pe PER,"FW,MF",Loko Moscow,33,1984,3.4,1,1,0,1,0,1,2,50.0,1,2,1,1,3,4,7,0,Matches,2019
189,Christian Fassnacht,ch SUI,MF,Young Boys,24,1993,4.2,8,4,2,5,1,4,7,57.1,3,3,0,3,6,14,4,0,Matches,2019
190,Federico Fazio,ar ARG,DF,Roma,31,1987,6.0,9,7,6,2,1,4,8,50.0,4,10,8,2,8,17,26,1,Matches,2019
191,Sofiane Feghouli,dz ALG,"MF,FW",Galatasaray,28,1989,1.5,1,0,1,0,0,1,2,50.0,1,2,0,2,0,1,1,0,Matches,2019
192,Ljubomir Fejsa,rs SRB,MF,Benfica,29,1988,4.8,20,14,10,9,1,8,14,57.1,6,15,2,13,6,26,4,0,Matches,2019
193,Nabil Fekir,fr FRA,"MF,FW",Lyon,25,1993,5.6,12,5,5,6,1,1,5,20.0,4,7,0,7,3,15,1,0,Matches,2019
194,Felipe,br BRA,DF,Porto,29,1989,10.3,13,8,10,2,1,7,11,63.6,4,9,6,3,21,34,61,0,Matches,2019
195,João Félix,pt POR,"FW,MF",Benfica,18,1999,0.8,2,2,1,1,0,1,1,100.0,0,1,0,1,0,2,0,0,Matches,2019
196,Marouane Fellaini,be BEL,MF,Manchester Utd,30,1987,3.4,11,6,4,7,0,4,8,50.0,4,5,0,5,5,16,11,0,Matches,2019
197,Gedson Fernandes,pt POR,MF,Benfica,19,1999,5.1,10,6,3,5,2,4,6,66.7,2,5,1,4,2,12,3,0,Matches,2019
198,Manuel Fernandes,pt POR,"FW,MF",Loko Moscow,32,1986,3.2,8,6,3,3,2,1,3,33.3,2,5,1,4,2,10,1,0,Matches,2019
199,Mário Fernandes,ru RUS,DF,CSKA Moscow,27,1990,5.1,13,10,9,3,1,10,14,71.4,4,5,2,3,13,26,21,0,Matches,2019
200,Fernandinho,br BRA,"MF,DF",Manchester City,33,1985,7.1,13,9,3,9,1,3,9,33.3,6,11,7,4,19,32,17,1,Matches,2019
201,Fernando,br BRA,"FW,MF",Porto,25,1993,1.6,7,4,7,0,0,1,3,33.3,2,2,0,2,0,7,2,0,Matches,2019
202,Fernando,br BRA,FW,Shakhtar,19,1999,0.9,1,0,1,0,0,0,0,,0,0,0,0,0,1,0,0,Matches,2019
203,Fernando,br BRA,MF,Galatasaray,31,1987,3.6,8,6,1,5,2,3,6,50.0,3,4,2,2,6,14,8,0,Matches,2019
204,Jordan Ferri,fr FRA,MF,Lyon,26,1992,0.1,0,0,0,0,0,0,1,0.0,1,0,0,0,0,0,0,0,Matches,2019
205,Roberto Firmino,br BRA,"FW,MF",Liverpool,26,1991,7.8,12,8,2,6,4,3,16,18.8,13,11,0,11,2,14,3,1,Matches,2019
206,Alessandro Florenzi,it ITA,"DF,FW",Roma,27,1991,6.9,15,9,8,6,1,3,11,27.3,8,9,1,8,9,24,12,0,Matches,2019
207,Phil Foden,eng ENG,MF,Manchester City,18,2000,1.4,1,1,1,0,0,0,6,0.0,6,1,0,1,0,1,2,0,Matches,2019
208,Hernâni Fortes,pt POR,"FW,MF",Porto,26,1991,1.4,3,2,1,1,1,0,0,,0,2,0,2,0,3,2,0,Matches,2019
209,Juan Foyth,ar ARG,DF,Tottenham,20,1998,1.1,1,1,0,1,0,1,3,33.3,2,2,0,2,5,6,0,1,Matches,2019
210,Fred,br BRA,MF,Manchester Utd,25,1993,5.1,11,7,8,3,0,5,18,27.8,13,10,2,8,5,16,5,0,Matches,2019
211,Gabriel,br BRA,"MF,FW",Benfica,24,1993,2.5,6,4,2,4,0,1,4,25.0,3,0,0,0,8,14,1,0,Matches,2019
212,Cody Gakpo,nl NED,MF,PSV Eindhoven,19,1999,0.1,0,0,0,0,0,0,0,,0,1,0,1,0,0,0,0,Matches,2019
213,Konstantinos Galanopoulos,gr GRE,MF,AEK Athens,20,1997,5.4,7,4,4,3,0,2,5,40.0,3,3,1,2,11,18,5,0,Matches,2019
214,Rodrigo Galo Brito,br BRA,"DF,MF",AEK Athens,31,1986,1.3,2,1,0,2,0,0,1,0.0,1,0,0,0,3,5,1,0,Matches,2019
215,Kévin Gameiro,fr FRA,FW,Valencia,31,1987,1.5,0,0,0,0,0,0,0,,0,0,0,0,1,1,0,0,Matches,2019
216,Ezequiel Garay,ar ARG,DF,Valencia,31,1986,2.4,2,2,2,0,0,2,2,100.0,0,5,5,0,7,9,14,0,Matches,2019
217,Ulisses Garcia,ch SUI,DF,Young Boys,22,1996,1.5,6,3,4,1,1,1,2,50.0,1,3,0,3,2,8,4,0,Matches,2019
218,Paulo Gazzaniga,ar ARG,GK,Tottenham,26,1992,1.0,0,0,0,0,0,0,0,,0,0,0,0,0,0,1,0,Matches,2019
219,David de Gea,es ESP,GK,Manchester Utd,27,1990,9.0,1,0,1,0,0,1,1,100.0,0,0,0,0,0,1,1,1,Matches,2019
220,Dennis Geiger,de GER,MF,Hoffenheim,20,1998,0.7,1,0,0,1,0,1,1,100.0,0,2,0,2,0,1,0,0,Matches,2019
221,Faouzi Ghoulam,dz ALG,DF,Napoli,27,1991,0.2,1,1,1,0,0,0,0,,0,0,0,0,0,1,0,0,Matches,2019
222,Giorgos Giakoumakis,gr GRE,FW,AEK Athens,23,1994,0.6,1,0,0,1,0,0,1,0.0,1,1,0,1,0,1,0,0,Matches,2019
223,Giannis Gianniotas,gr GRE,"FW,MF",AEK Athens,25,1993,0.6,0,0,0,0,0,0,1,0.0,1,0,0,0,0,0,0,0,Matches,2019
224,Kamil Glik,pl POL,DF,Monaco,30,1988,4.8,11,6,8,3,0,4,5,80.0,1,2,1,1,7,18,32,0,Matches,2019
225,Serge Gnabry,de GER,"FW,MF",Bayern Munich,23,1995,4.9,14,8,6,4,4,4,14,28.6,10,9,2,7,6,20,2,0,Matches,2019
226,Marko Gobeljić,rs SRB,DF,Red Star,25,1992,3.4,7,3,6,1,0,3,4,75.0,1,6,1,5,11,18,14,0,Matches,2019
227,Diego Godín,uy URU,DF,Atlético Madrid,32,1986,6.0,3,2,1,2,0,0,3,0.0,3,4,3,1,9,12,21,0,Matches,2019
228,Benjamin Goller,de GER,MF,Schalke 04,19,1999,0.6,1,0,0,1,0,0,1,0.0,1,1,0,1,0,1,0,0,Matches,2019
229,Aleksandr Golovin,ru RUS,"FW,MF",Monaco,22,1996,2.5,6,6,4,2,0,0,0,,0,1,0,1,4,10,1,0,Matches,2019
230,Joe Gomez,eng ENG,DF,Liverpool,21,1997,5.9,8,1,6,1,1,3,8,37.5,5,1,0,1,6,14,14,0,Matches,2019
231,Sergio Gómez,es ESP,FW,Dortmund,17,2000,0.0,0,0,0,0,0,0,0,,0,0,0,0,0,0,0,0,Matches,2019
232,Leon Goretzka,de GER,MF,Bayern Munich,23,1995,3.6,11,7,6,5,0,5,9,55.6,4,5,1,4,5,16,1,0,Matches,2019
233,Mathieu Gorgelin,fr FRA,GK,Lyon,27,1990,0.6,0,0,0,0,0,0,1,0.0,1,0,0,0,0,0,0,0,Matches,2019
234,Mario Götze,de GER,"MF,FW",Dortmund,26,1992,4.9,15,6,2,8,5,4,10,40.0,6,1,0,1,3,18,4,0,Matches,2019
235,Gobe Gouano,fr FRA,FW,Monaco,17,2000,0.3,0,0,0,0,0,0,0,,0,0,0,0,0,0,0,0,Matches,2019
236,Samuel Grandsir,fr FRA,"MF,FW",Monaco,21,1996,2.1,4,1,4,0,0,2,3,66.7,1,5,0,5,3,7,0,0,Matches,2019
237,Mason Greenwood,eng ENG,MF,Manchester Utd,16,2001,0.0,0,0,0,0,0,0,0,,0,0,0,0,1,1,0,0,Matches,2019
238,Antoine Griezmann,fr FRA,FW,Atlético Madrid,27,1991,8.0,9,7,6,1,2,3,10,30.0,7,3,0,3,4,13,7,0,Matches,2019
239,Vincenzo Grifo,it ITA,DF,Hoffenheim,25,1993,0.1,1,0,1,0,0,0,1,0.0,1,0,0,0,0,1,0,0,Matches,2019
240,Florian Grillitsch,at AUT,MF,Hoffenheim,22,1995,4.6,14,5,12,2,0,5,16,31.3,11,4,1,3,11,25,4,0,Matches,2019
241,Álex Grimaldo,es ESP,DF,Benfica,22,1995,6.0,25,17,15,8,2,16,24,66.7,8,2,0,2,7,32,14,0,Matches,2019
242,Gonçalo Guedes,pt POR,MF,Valencia,21,1996,3.5,5,1,0,2,3,2,5,40.0,3,3,0,3,2,7,0,0,Matches,2019
243,Raphaël Guerreiro,pt POR,"FW,MF",Dortmund,24,1993,3.2,5,3,3,2,0,1,1,100.0,0,4,0,4,7,12,1,0,Matches,2019
244,Sinan Gümüş,tr TUR,FW,Galatasaray,24,1994,2.5,1,1,0,1,0,0,1,0.0,1,0,0,0,0,1,1,0,Matches,2019
245,İlkay Gündoğan,de GER,MF,Manchester City,27,1990,6.5,9,6,1,7,1,4,13,30.8,9,5,0,5,8,17,5,0,Matches,2019
246,Erick Gutiérrez,mx MEX,MF,PSV Eindhoven,23,1995,1.1,2,1,1,0,1,2,6,33.3,4,0,0,0,1,3,1,0,Matches,2019
247,Robin Hack,de GER,MF,Hoffenheim,19,1998,0.1,0,0,0,0,0,0,0,,0,0,0,0,0,0,0,0,Matches,2019
248,Munir El Haddadi,ma MAR,FW,Barcelona,22,1995,0.7,0,0,0,0,0,0,0,,0,0,0,0,0,0,1,0,Matches,2019
249,Achraf Hakimi,ma MAR,DF,Dortmund,19,1998,4.1,9,7,5,4,0,5,14,35.7,9,7,1,6,4,13,3,0,Matches,2019
250,Marek Hamšík,sk SVK,MF,Napoli,31,1987,5.1,12,9,5,5,2,5,15,33.3,10,1,0,1,4,16,8,0,Matches,2019
251,Samir Handanović,si SVN,GK,Inter,34,1984,6.0,0,0,0,0,0,0,1,0.0,1,1,0,1,1,1,2,0,Matches,2019
252,Amine Harit,ma MAR,"MF,FW",Schalke 04,21,1997,1.6,1,1,1,0,0,1,2,50.0,1,0,0,0,2,3,0,0,Matches,2019
253,Milan Havel,cz CZE,"FW,DF",Viktoria Plzeň,23,1994,2.5,2,1,0,0,2,2,3,66.7,1,4,1,3,6,8,3,0,Matches,2019
254,Lukáš Hejda,cz CZE,DF,Viktoria Plzeň,28,1990,5.0,11,7,10,1,0,7,10,70.0,3,5,3,2,11,22,31,0,Matches,2019
255,Jordan Henderson,eng ENG,MF,Liverpool,28,1990,8.9,18,15,3,12,3,6,15,40.0,9,9,0,9,13,31,10,0,Matches,2019
256,Jorrit Hendrix,nl NED,MF,PSV Eindhoven,23,1995,5.8,11,5,8,2,1,2,11,18.2,9,14,4,10,13,24,21,0,Matches,2019
257,Benjamin Henrichs,de GER,"DF,MF",Monaco,21,1997,3.3,4,3,1,2,1,1,3,33.3,2,6,0,6,4,8,3,0,Matches,2019
258,Lucas Hernández,fr FRA,DF,Atlético Madrid,22,1996,5.0,7,3,4,3,0,3,3,100.0,0,2,1,1,6,13,19,0,Matches,2019
259,Ander Herrera,es ESP,MF,Manchester Utd,28,1989,1.9,7,2,3,2,2,0,3,0.0,3,4,1,3,2,9,3,0,Matches,2019
260,Héctor Herrera,mx MEX,MF,Porto,28,1990,9.2,14,10,6,8,0,2,10,20.0,8,13,1,12,7,21,7,0,Matches,2019
261,Son Heung-min,kr KOR,FW,Tottenham,26,1992,10.0,14,8,7,5,2,5,24,20.8,19,13,1,12,5,19,8,0,Matches,2019
262,Marwin Hitz,ch SUI,GK,Dortmund,30,1987,1.0,0,0,0,0,0,0,0,,0,0,0,0,0,0,0,0,Matches,2019
263,Guillaume Hoarau,fr FRA,FW,Young Boys,34,1984,4.5,8,5,3,4,1,1,8,12.5,7,4,2,2,0,8,12,0,Matches,2019
264,Justin Hoogma,nl NED,MF,Hoffenheim,20,1998,1.0,8,4,7,1,0,2,3,66.7,1,2,1,1,1,9,4,0,Matches,2019
265,Tomáš Hořava,cz CZE,MF,Viktoria Plzeň,30,1988,2.4,4,1,1,3,0,2,7,28.6,5,3,1,2,4,8,1,0,Matches,2019
266,Ethan Horvath,us USA,GK,Club Brugge,23,1995,3.0,0,0,0,0,0,0,0,,0,0,0,0,0,0,1,0,Matches,2019
267,Benedikt Höwedes,de GER,DF,Loko Moscow,30,1988,5.0,10,9,6,3,1,4,7,57.1,3,7,6,1,7,17,12,1,Matches,2019
268,Patrik Hrošovský,sk SVK,MF,Viktoria Plzeň,26,1992,6.0,11,9,4,7,0,5,14,35.7,9,10,1,9,5,16,11,0,Matches,2019
269,Aleš Hruška,cz CZE,GK,Viktoria Plzeň,32,1985,4.0,0,0,0,0,0,0,0,,0,0,0,0,1,1,1,1,Matches,2019
270,Benjamin Hübner,de GER,DF,Hoffenheim,29,1989,1.0,1,0,1,0,0,1,2,50.0,1,0,0,0,1,2,5,1,Matches,2019
271,Roman Hubník,cz CZE,DF,Viktoria Plzeň,34,1984,6.0,13,10,10,1,2,6,8,75.0,2,8,4,4,12,25,47,0,Matches,2019
272,Niklas Hult,se SWE,DF,AEK Athens,28,1990,6.0,11,6,8,3,0,5,7,71.4,2,4,0,4,10,21,13,0,Matches,2019
273,Mats Hummels,de GER,DF,Bayern Munich,29,1988,6.0,22,16,12,8,2,8,13,61.5,5,5,2,3,11,33,22,1,Matches,2019
274,Klaas-Jan Huntelaar,nl NED,FW,Ajax,34,1983,1.1,0,0,0,0,0,0,2,0.0,2,0,0,0,2,2,0,0,Matches,2019
275,Elseid Hysaj,al ALB,DF,Napoli,24,1994,1.7,4,3,3,1,0,2,3,66.7,1,0,0,0,1,5,4,0,Matches,2019
276,Mauro Icardi,ar ARG,FW,Inter,25,1993,6.0,2,1,1,1,0,0,0,,0,2,0,2,2,4,9,0,Matches,2019
277,Brian Idowu,ng NGA,DF,Loko Moscow,26,1992,3.0,6,5,3,2,1,2,4,50.0,2,3,1,2,8,14,6,0,Matches,2019
278,Vladislav Ignatyev,ru RUS,DF,Loko Moscow,31,1987,5.8,15,11,9,6,0,6,18,33.3,12,7,3,4,17,32,20,0,Matches,2019
279,Selçuk İnan,tr TUR,MF,Galatasaray,33,1985,1.2,2,1,2,0,0,1,3,33.3,2,1,0,1,0,2,1,0,Matches,2019
280,Lorenzo Insigne,it ITA,FW,Napoli,27,1991,5.4,1,1,0,0,1,0,4,0.0,4,1,0,1,1,2,0,0,Matches,2019
281,Isco,es ESP,"FW,MF",Real Madrid,26,1992,2.8,4,4,2,2,0,2,5,40.0,3,1,0,1,2,6,0,0,Matches,2019
282,Nicolas Isimat-Mirin,fr FRA,DF,PSV Eindhoven,26,1991,0.3,1,1,1,0,0,0,0,,0,0,0,0,0,1,3,0,Matches,2019
283,Ismaily,br BRA,DF,Shakhtar,28,1990,6.0,17,12,11,5,1,4,9,44.4,5,8,3,5,7,24,17,0,Matches,2019
284,Jardel,br BRA,DF,Benfica,32,1986,4.0,6,4,4,2,0,1,1,100.0,0,4,2,2,8,14,12,0,Matches,2019
285,Jemerson,br BRA,DF,Monaco,25,1992,5.0,5,4,4,1,0,0,2,0.0,2,2,0,2,6,11,20,0,Matches,2019
286,Gabriel Jesus,br BRA,FW,Manchester City,21,1997,4.2,2,1,1,1,0,0,2,0.0,2,5,0,5,1,3,6,0,Matches,2019
287,Juan Jesus,br BRA,DF,Roma,27,1991,2.4,3,2,3,0,0,2,2,100.0,0,4,1,3,2,5,13,0,Matches,2019
288,Joelinton,br BRA,FW,Hoffenheim,21,1996,4.3,11,7,5,4,2,6,10,60.0,4,5,1,4,4,15,2,0,Matches,2019
289,Jonas,br BRA,FW,Benfica,34,1984,1.2,0,0,0,0,0,0,1,0.0,1,1,0,1,0,0,0,0,Matches,2019
290,Phil Jones,eng ENG,DF,Manchester Utd,26,1992,3.0,4,2,1,3,0,0,4,0.0,4,6,5,1,7,11,12,0,Matches,2019
291,Frenkie de Jong,nl NED,MF,Ajax,21,1997,10.9,27,16,14,11,2,12,30,40.0,18,12,3,9,19,46,22,2,Matches,2019
292,Luuk de Jong,nl NED,"FW,MF",PSV Eindhoven,27,1990,5.9,8,5,4,4,0,3,9,33.3,6,11,4,7,7,15,13,0,Matches,2019
293,Jorge,br BRA,"MF,FW",Porto,22,1996,0.2,0,0,0,0,0,0,0,,0,0,0,0,0,0,2,0,Matches,2019
294,Dušan Jovančić,rs SRB,MF,Red Star,27,1990,3.0,7,3,3,3,1,4,8,50.0,4,4,1,3,4,11,6,0,Matches,2019
295,Dejan Joveljić,rs SRB,FW,Red Star,18,1999,0.6,1,0,0,1,0,1,2,50.0,1,1,0,1,0,1,0,0,Matches,2019
296,Stevan Jovetić,me MNE,FW,Monaco,28,1989,0.1,0,0,0,0,0,0,0,,0,0,0,0,0,0,0,0,Matches,2019
297,Branko Jovičić,rs SRB,MF,Red Star,25,1993,2.6,7,5,4,3,0,1,5,20.0,4,6,2,4,6,13,9,0,Matches,2019
298,Juanfran,es ESP,DF,Atlético Madrid,33,1985,5.0,12,10,9,3,0,10,11,90.9,1,7,1,6,11,23,10,0,Matches,2019
299,Vinicius Júnior,br BRA,FW,Real Madrid,18,2000,2.6,6,4,3,2,1,2,3,66.7,1,2,0,2,0,6,0,0,Matches,2019
300,Ozan Kabak,tr TUR,DF,Galatasaray,18,2000,4.0,17,9,7,10,0,7,10,70.0,3,3,2,1,13,30,12,1,Matches,2019
301,Pavel Kadeřábek,cz CZE,"DF,MF",Hoffenheim,26,1992,6.0,10,7,5,5,0,5,10,50.0,5,6,2,4,4,14,22,0,Matches,2019
302,Shinji Kagawa,jp JPN,MF,Dortmund,29,1989,0.3,0,0,0,0,0,0,0,,0,0,0,0,0,0,1,0,Matches,2019
303,Nikola Kalinić,hr CRO,FW,Atlético Madrid,30,1988,1.2,0,0,0,0,0,0,1,0.0,1,1,0,1,0,0,2,0,Matches,2019
304,Harry Kane,eng ENG,FW,Tottenham,25,1993,8.6,9,6,0,7,2,1,3,33.3,2,4,1,3,2,11,7,0,Matches,2019
305,Rick Karsdorp,nl NED,"MF,DF",Roma,23,1995,0.8,3,2,2,1,0,2,3,66.7,1,1,1,0,1,4,3,2,Matches,2019
306,Olarenwaju Kayode,ng NGA,"FW,MF",Shakhtar,25,1993,0.5,1,1,0,1,0,0,1,0.0,1,0,0,0,2,3,0,0,Matches,2019
307,Moise Kean,it ITA,FW,Juventus,18,2000,0.8,0,0,0,0,0,0,0,,0,0,0,0,0,0,0,0,Matches,2019
308,Thilo Kehrer,de GER,DF,Paris S-G,21,1996,5.4,10,7,6,4,0,4,12,33.3,8,7,2,5,5,15,13,1,Matches,2019
309,Naby Keïta,gn GUI,MF,Liverpool,23,1995,2.7,13,8,3,9,1,7,13,53.8,6,4,1,3,5,18,3,0,Matches,2019
310,Sami Khedira,de GER,MF,Juventus,31,1987,1.2,0,0,0,0,0,0,2,0.0,2,1,0,1,0,0,1,0,Matches,2019
311,Davit Khocholava,ge GEO,DF,Shakhtar,25,1993,2.5,1,0,1,0,0,0,1,0.0,1,3,2,1,4,5,19,0,Matches,2019
312,Khetag Khosonov,ru RUS,"MF,DF",CSKA Moscow,20,1998,0.5,0,0,0,0,0,0,0,,0,0,0,0,0,0,0,0,Matches,2019
313,Joshua Kimmich,de GER,"DF,MF",Bayern Munich,23,1995,7.0,11,6,7,2,2,4,9,44.4,5,9,2,7,12,23,8,0,Matches,2019
314,Presnel Kimpembe,fr FRA,DF,Paris S-G,22,1995,7.2,15,8,8,6,1,4,7,57.1,3,2,1,1,12,27,17,0,Matches,2019
315,Viktor Klonaridis,be BEL,"MF,FW",AEK Athens,26,1992,3.5,1,1,1,0,0,1,2,50.0,1,2,0,2,1,2,0,0,Matches,2019
316,Justin Kluivert,nl NED,FW,Roma,19,1999,3.5,8,6,2,3,3,4,5,80.0,1,4,1,3,2,10,2,0,Matches,2019
317,Koke,es ESP,MF,Atlético Madrid,26,1992,6.2,14,6,6,7,1,8,22,36.4,14,4,0,4,7,21,9,0,Matches,2019
318,Daniel Kolář,cz CZE,"FW,MF",Viktoria Plzeň,32,1985,1.0,1,0,0,0,1,0,0,,0,0,0,0,0,1,0,0,Matches,2019
319,Aleksandar Kolarov,rs SRB,"DF,MF",Roma,32,1985,7.3,4,1,3,1,0,1,4,25.0,3,6,0,6,4,8,20,0,Matches,2019
320,Vincent Kompany,be BEL,DF,Manchester City,32,1986,2.3,3,1,2,1,0,1,2,50.0,1,1,1,0,3,6,7,0,Matches,2019
321,Geoffrey Kondogbia,cf CTA,MF,Valencia,25,1993,4.5,16,10,10,5,1,9,16,56.3,7,8,3,5,13,29,11,0,Matches,2019
322,Yevhen Konoplyanka,ua UKR,"FW,MF",Schalke 04,28,1989,5.1,2,2,2,0,0,1,8,12.5,7,3,0,3,1,3,4,0,Matches,2019
323,Jan Kopic,cz CZE,"MF,FW",Viktoria Plzeň,28,1990,3.3,2,2,2,0,0,1,5,20.0,4,3,0,3,2,4,4,0,Matches,2019
324,Kalidou Koulibaly,sn SEN,DF,Napoli,27,1991,6.0,14,9,9,5,0,7,10,70.0,3,10,7,3,12,26,24,0,Matches,2019
325,Viktor Kovalenko,ua UKR,"MF,FW",Shakhtar,22,1996,4.1,4,3,1,3,0,1,6,16.7,5,1,0,1,2,6,2,0,Matches,2019
326,Jan Kovařík,cz CZE,"FW,MF",Viktoria Plzeň,30,1988,4.0,1,0,1,0,0,1,1,100.0,0,2,1,1,2,3,5,0,Matches,2019
327,Matúš Kozáčik,sk SVK,GK,Viktoria Plzeň,34,1983,2.0,0,0,0,0,0,0,0,,0,0,0,0,0,0,0,0,Matches,2019
328,Andrej Kramarić,hr CRO,"MF,FW",Hoffenheim,27,1991,5.3,1,0,0,1,0,0,4,0.0,4,1,0,1,2,3,2,0,Matches,2019
329,Michal Krmenčík,cz CZE,FW,Viktoria Plzeň,25,1993,2.7,0,0,0,0,0,0,0,,0,0,0,0,2,2,2,0,Matches,2019
330,Toni Kroos,de GER,MF,Real Madrid,28,1990,7.2,17,10,3,9,5,5,22,22.7,17,4,2,2,9,26,3,4,Matches,2019
331,Nenad Krstičić,rs SRB,MF,Red Star,28,1990,4.8,8,6,6,2,0,3,13,23.1,10,9,0,9,16,24,10,0,Matches,2019
332,Grzegorz Krychowiak,pl POL,"MF,DF",Loko Moscow,28,1990,6.0,12,7,2,7,3,3,6,50.0,3,6,1,5,7,19,15,1,Matches,2019
333,Serhiy Kryvtsov,ua UKR,DF,Shakhtar,27,1991,5.0,5,3,5,0,0,3,4,75.0,1,9,5,4,13,18,14,1,Matches,2019
334,Konstantin Kuchayev,ru RUS,MF,CSKA Moscow,20,1998,0.2,0,0,0,0,0,0,0,,0,2,0,2,1,1,0,0,Matches,2019
335,Ahmed Kutucu,tr TUR,FW,Schalke 04,18,2000,0.2,0,0,0,0,0,0,0,,0,0,0,0,0,0,0,0,Matches,2019
336,Solomon Kvirkvelia,ge GEO,DF,Loko Moscow,26,1992,4.8,11,9,6,5,0,1,3,33.3,2,7,4,3,9,20,28,0,Matches,2019
337,Georgii Kyrnats,ru RUS,"GK,MF",CSKA Moscow,20,1998,0.0,0,0,0,0,0,0,0,,0,0,0,0,0,0,0,0,Matches,2019
338,Zakaria Labyad,ma MAR,MF,Ajax,25,1993,0.1,0,0,0,0,0,0,0,,0,0,0,0,0,0,0,0,Matches,2019
339,Adam Lallana,eng ENG,"MF,FW",Liverpool,30,1988,1.2,0,0,0,0,0,0,2,0.0,2,0,0,0,2,2,0,0,Matches,2019
340,Vassilis Lambropoulos,gr GRE,DF,AEK Athens,28,1990,3.0,5,5,3,2,0,0,2,0.0,2,6,6,0,4,9,21,0,Matches,2019
341,Érik Lamela,ar ARG,"FW,MF",Tottenham,26,1992,3.7,11,5,3,6,2,2,5,40.0,3,7,0,7,2,13,2,0,Matches,2019
342,Aymeric Laporte,es ESP,DF,Manchester City,24,1994,9.8,12,9,7,4,1,4,8,50.0,4,4,3,1,16,28,37,3,Matches,2019
343,Toni Lato,es ESP,DF,Valencia,20,1997,0.6,0,0,0,0,0,0,0,,0,0,0,0,2,2,0,0,Matches,2019
344,Sandro Lauper,ch SUI,"DF,MF",Young Boys,21,1996,4.5,14,10,7,6,1,7,14,50.0,7,9,4,5,11,25,21,0,Matches,2019
345,Diogo Leite,pt POR,DF,Porto,19,1999,1.0,0,0,0,0,0,0,0,,0,1,0,1,1,1,6,0,Matches,2019
346,Cristian Lema,ar ARG,DF,Benfica,28,1990,0.5,0,0,0,0,0,0,1,0.0,1,2,2,0,0,0,4,0,Matches,2019
347,Thomas Lemar,fr FRA,"MF,FW",Atlético Madrid,22,1995,4.5,8,4,1,7,0,2,7,28.6,5,6,1,5,3,11,4,0,Matches,2019
348,Clément Lenglet,fr FRA,DF,Barcelona,23,1995,11.1,28,19,16,12,0,13,19,68.4,6,17,11,6,8,36,40,1,Matches,2019
349,Karlo Letica,hr CRO,GK,Club Brugge,21,1997,3.0,0,0,0,0,0,0,1,0.0,1,0,0,0,0,0,0,0,Matches,2019
350,Robert Lewandowski,pl POL,FW,Bayern Munich,29,1988,7.9,2,1,0,2,0,0,4,0.0,4,8,0,8,6,8,5,0,Matches,2019
351,Matthijs de Ligt,nl NED,DF,Ajax,18,1999,11.0,16,12,11,3,2,5,13,38.5,8,12,8,4,15,31,49,0,Matches,2019
352,David Limberský,cz CZE,DF,Viktoria Plzeň,34,1983,5.5,4,3,3,1,0,4,7,57.1,3,5,1,4,6,10,13,0,Matches,2019
353,Victor Lindelöf,se SWE,DF,Manchester Utd,24,1994,7.0,4,3,1,3,0,3,7,42.9,4,6,3,3,9,13,31,0,Matches,2019
354,Jesse Lingard,eng ENG,"FW,MF",Manchester Utd,25,1992,3.3,4,2,1,2,1,1,6,16.7,5,7,0,7,0,4,0,0,Matches,2019
355,Martin Linnes,no NOR,DF,Galatasaray,26,1991,4.5,16,10,12,4,0,9,11,81.8,2,9,2,7,1,17,7,1,Matches,2019
356,Marko Livaja,hr CRO,FW,AEK Athens,24,1993,0.7,3,1,3,0,0,0,0,,0,0,0,0,0,3,0,0,Matches,2019
357,Fernando Llorente,es ESP,FW,Tottenham,33,1985,2.7,2,0,0,1,1,1,4,25.0,3,0,0,0,0,2,10,0,Matches,2019
358,Marcos Llorente,es ESP,MF,Real Madrid,23,1995,1.6,4,4,1,3,0,3,6,50.0,3,0,0,0,1,5,1,0,Matches,2019
359,Hugo Lloris,fr FRA,GK,Tottenham,31,1986,10.9,0,0,0,0,0,0,0,,0,0,0,0,0,0,2,1,Matches,2019
360,Anthony Lopes,pt POR,GK,Lyon,27,1990,7.4,1,0,1,0,0,1,1,100.0,0,0,0,0,0,1,3,0,Matches,2019
361,Adrián López,es ESP,"FW,MF",Porto,30,1988,1.3,1,1,0,1,0,1,4,25.0,3,1,0,1,1,2,0,0,Matches,2019
362,Dejan Lovren,hr CRO,DF,Liverpool,29,1989,2.0,3,3,2,1,0,3,3,100.0,0,2,1,1,1,4,11,0,Matches,2019
363,Hirving Lozano,mx MEX,FW,PSV Eindhoven,23,1995,6.0,8,5,3,1,4,1,17,5.9,16,11,1,10,4,12,4,0,Matches,2019
364,Filipe Luís,br BRA,DF,Atlético Madrid,32,1985,4.5,11,10,8,2,1,6,8,75.0,2,7,0,7,16,27,3,1,Matches,2019
365,José Luis Gayà,es ESP,DF,Valencia,23,1995,5.0,9,6,8,1,0,7,9,77.8,2,3,1,2,5,14,14,0,Matches,2019
366,Romelu Lukaku,be BEL,FW,Manchester Utd,25,1993,6.1,3,1,1,1,1,2,4,50.0,2,1,0,1,0,3,5,0,Matches,2019
367,Mikhail Lysov,ru RUS,DF,Loko Moscow,20,1998,0.1,0,0,0,0,0,0,1,0.0,1,0,0,0,0,0,0,0,Matches,2019
368,Lisandro Magallán,ar ARG,DF,Ajax,24,1993,0.1,1,1,1,0,0,0,0,,0,0,0,0,0,1,0,0,Matches,2019
369,Hörður Magnússon,is ISL,DF,CSKA Moscow,25,1993,2.6,1,1,1,0,0,0,2,0.0,2,6,2,4,2,3,25,0,Matches,2019
370,Riyad Mahrez,dz ALG,FW,Manchester City,27,1991,4.3,9,5,1,7,1,3,9,33.3,6,8,1,7,1,10,10,0,Matches,2019
371,Maicon,br BRA,DF,Galatasaray,29,1988,3.2,9,6,5,4,0,4,7,57.1,3,8,5,3,6,15,7,0,Matches,2019
372,Nikola Maksimović,rs SRB,DF,Napoli,26,1991,4.8,2,2,1,1,0,1,2,50.0,1,3,2,1,5,7,23,0,Matches,2019
373,Malcom,br BRA,"FW,MF",Barcelona,21,1997,0.5,0,0,0,0,0,0,0,,0,0,0,0,0,0,0,0,Matches,2019
374,Donyell Malen,nl NED,"FW,MF",PSV Eindhoven,19,1999,2.0,5,1,2,1,2,0,1,0.0,1,2,0,2,0,5,3,0,Matches,2019
375,Mario Mandžukić,hr CRO,FW,Juventus,32,1986,6.4,8,5,1,7,0,0,2,0.0,2,3,1,2,4,12,7,0,Matches,2019
376,Sadio Mané,sn SEN,FW,Liverpool,26,1992,12.8,20,14,9,9,2,2,8,25.0,6,10,2,8,5,25,5,1,Matches,2019
377,Kostas Manolas,gr GRE,DF,Roma,27,1991,7.3,9,8,5,4,0,2,6,33.3,4,12,9,3,10,19,30,1,Matches,2019
378,Petros Mantalos,gr GRE,"FW,MF",AEK Athens,26,1991,4.8,8,4,3,4,1,1,11,9.1,10,6,1,5,4,12,1,0,Matches,2019
379,Fernando Marçal,br BRA,DF,Lyon,29,1989,3.0,1,1,1,0,0,1,4,25.0,3,2,2,0,8,9,5,0,Matches,2019
380,Iván Marcano,es ESP,DF,Roma,31,1987,1.8,2,0,2,0,0,1,3,33.3,2,3,1,2,3,5,4,0,Matches,2019
381,Marcelo,br BRA,DF,Real Madrid,30,1988,3.8,4,4,2,1,1,2,6,33.3,4,5,0,5,2,6,5,0,Matches,2019
382,Marcelo,br BRA,DF,Lyon,31,1987,8.0,10,4,7,3,0,2,6,33.3,4,8,7,1,18,28,56,0,Matches,2019
383,Moussa Marega,ml MLI,FW,Porto,27,1991,9.3,8,6,2,3,3,2,3,66.7,1,10,2,8,2,10,7,0,Matches,2019
384,José María Giménez,uy URU,DF,Atlético Madrid,23,1995,4.0,5,3,3,2,0,3,4,75.0,1,4,3,1,7,12,29,0,Matches,2019
385,Mariano,do DOM,FW,Real Madrid,24,1993,0.9,0,0,0,0,0,0,0,,0,2,0,2,0,0,2,0,Matches,2019
386,Mariano,br BRA,DF,Galatasaray,32,1986,2.0,4,1,3,1,0,3,6,50.0,3,1,0,1,2,6,3,0,Matches,2019
387,Marko Marin,de GER,"MF,FW",Red Star,29,1989,4.6,5,4,2,1,2,0,9,0.0,9,1,0,1,4,9,1,0,Matches,2019
388,Guilherme Marinato,ru RUS,GK,Loko Moscow,32,1985,6.0,0,0,0,0,0,0,0,,0,0,0,0,0,0,4,2,Matches,2019
389,Marlos,ua UKR,FW,Shakhtar,30,1988,2.9,1,1,0,1,0,0,3,0.0,3,1,0,1,2,3,0,0,Matches,2019
390,Marquinhos,br BRA,"MF,DF",Paris S-G,24,1994,7.0,11,6,3,7,1,2,5,40.0,3,7,2,5,11,22,14,0,Matches,2019
391,Anthony Martial,fr FRA,"FW,MF",Manchester Utd,22,1995,5.6,4,3,1,3,0,2,2,100.0,0,4,0,4,1,5,4,0,Matches,2019
392,Javi Martínez,es ESP,MF,Bayern Munich,29,1988,5.8,18,9,7,9,2,3,7,42.9,4,7,2,5,20,38,10,0,Matches,2019
393,Lautaro Martínez,ar ARG,MF,Inter,20,1997,0.6,1,0,0,1,0,0,1,0.0,1,5,1,4,0,1,0,0,Matches,2019
394,Gelson Martins,pt POR,FW,Atlético Madrid,23,1995,1.0,0,0,0,0,0,0,0,,0,1,0,1,0,0,1,0,Matches,2019
395,Omar Mascarell,es ESP,MF,Schalke 04,25,1993,2.5,4,3,0,3,1,1,4,25.0,3,6,1,5,2,6,4,0,Matches,2019
396,Han-Noah Massengo,fr FRA,MF,Monaco,17,2001,2.0,4,3,2,1,1,1,1,100.0,0,3,0,3,5,9,3,0,Matches,2019
397,Clinton Mata,ao ANG,DF,Club Brugge,25,1992,2.3,15,12,9,3,3,6,10,60.0,4,2,0,2,3,18,5,0,Matches,2019
398,Juan Mata,es ESP,"MF,FW",Manchester Utd,30,1988,3.1,4,2,2,0,2,2,6,33.3,4,2,0,2,0,4,4,0,Matches,2019
399,Nemanja Matić,rs SRB,MF,Manchester Utd,29,1988,6.0,13,7,8,5,0,7,13,53.8,6,13,5,8,7,20,10,1,Matches,2019
400,Joël Matip,cm CMR,DF,Liverpool,26,1991,8.0,13,8,9,3,1,8,14,57.1,6,10,3,7,14,27,38,0,Matches,2019
401,Blaise Matuidi,fr FRA,MF,Juventus,31,1987,7.6,15,10,5,8,2,4,9,44.4,5,9,2,7,11,26,8,0,Matches,2019
402,Mykola Matviyenko,ua UKR,DF,Shakhtar,22,1996,5.0,10,5,7,3,0,4,7,57.1,3,6,1,5,13,23,15,1,Matches,2019
403,Eric Maxim Choupo-Moting,cm CMR,"MF,FW",Paris S-G,29,1989,0.6,1,1,1,0,0,0,0,,0,0,0,0,0,1,0,0,Matches,2019
404,Maycon,br BRA,MF,Shakhtar,21,1997,5.0,7,2,3,4,0,3,18,16.7,15,5,1,4,9,16,7,2,Matches,2019
405,Noussair Mazraoui,ma MAR,DF,Ajax,20,1997,9.2,37,24,18,16,3,19,29,65.5,10,15,2,13,21,58,18,1,Matches,2019
406,Kevin Mbabu,ch SUI,DF,Young Boys,23,1995,5.0,20,12,16,4,0,9,16,56.3,7,7,2,5,3,23,9,0,Matches,2019
407,Kylian Mbappé,fr FRA,FW,Paris S-G,19,1998,7.8,1,0,0,1,0,0,3,0.0,3,0,0,0,1,2,0,0,Matches,2019
408,Jordi Mboula,es ESP,MF,Monaco,19,1999,0.4,0,0,0,0,0,0,1,0.0,1,1,0,1,1,1,0,0,Matches,2019
409,Weston McKennie,us USA,"MF,DF",Schalke 04,19,1998,4.1,7,4,4,3,0,3,8,37.5,5,6,2,4,13,20,6,0,Matches,2019
410,Scott McTominay,sct SCO,MF,Manchester Utd,21,1996,3.0,9,6,7,2,0,0,1,0.0,1,3,0,3,3,12,3,0,Matches,2019
411,Brandon Mechele,be BEL,DF,Club Brugge,25,1993,5.0,8,2,8,0,0,1,2,50.0,1,13,6,7,6,14,34,0,Matches,2019
412,Arthur Melo,br BRA,MF,Barcelona,21,1996,6.2,12,11,2,7,3,3,6,50.0,3,4,2,2,2,14,3,1,Matches,2019
413,Memphis,nl NED,FW,Lyon,24,1994,6.8,0,0,0,0,0,0,2,0.0,2,3,1,2,1,1,0,0,Matches,2019
414,Benjamin Mendy,fr FRA,DF,Manchester City,24,1994,1.9,6,5,3,2,1,3,5,60.0,2,0,0,0,1,7,1,0,Matches,2019
415,Ferland Mendy,fr FRA,"DF,MF",Lyon,23,1995,7.8,7,5,5,1,1,3,6,50.0,3,4,1,3,9,16,18,0,Matches,2019
416,Hamza Mendyl,ma MAR,"DF,MF",Schalke 04,20,1997,4.1,8,4,7,1,0,6,9,66.7,3,4,1,3,9,17,6,0,Matches,2019
417,Dries Mertens,be BEL,FW,Napoli,31,1987,4.2,2,0,1,0,1,1,7,14.3,6,1,0,1,0,2,1,0,Matches,2019
418,Lionel Messi,ar ARG,FW,Barcelona,31,1987,9.3,10,10,1,4,5,3,7,42.9,4,6,0,6,3,13,0,0,Matches,2019
419,Thomas Meunier,be BEL,DF,Paris S-G,26,1991,4.0,4,2,4,0,0,1,2,50.0,1,2,1,1,4,8,14,0,Matches,2019
420,Arkadiusz Milik,pl POL,FW,Napoli,24,1994,2.1,1,1,0,1,0,0,2,0.0,2,2,0,2,1,2,2,0,Matches,2019
421,Éder Militão,br BRA,DF,Porto,20,1998,9.1,23,14,15,7,1,11,16,68.8,5,10,4,6,17,40,43,1,Matches,2019
422,James Milner,eng ENG,"MF,DF",Liverpool,32,1986,10.0,24,14,9,11,4,14,24,58.3,10,15,1,14,9,33,13,0,Matches,2019
423,Santi Mina,es ESP,"FW,MF",Valencia,22,1995,2.5,1,1,1,0,0,0,4,0.0,4,2,0,2,0,1,2,0,Matches,2019
424,Aleksei Miranchuk,ru RUS,"MF,FW",Loko Moscow,22,1995,5.7,7,6,3,3,1,2,10,20.0,8,10,0,10,11,18,2,0,Matches,2019
425,Anton Miranchuk,ru RUS,"FW,MF",Loko Moscow,22,1995,4.3,7,4,3,3,1,5,8,62.5,3,3,0,3,2,9,4,0,Matches,2019
426,Miranda,br BRA,DF,Inter,33,1984,2.1,3,2,3,0,0,0,0,,0,2,1,1,3,6,7,0,Matches,2019
427,Juan Miranda,es ESP,DF,Barcelona,18,2000,1.0,2,1,2,0,0,0,0,,0,5,2,3,4,6,1,0,Matches,2019
428,Antonio Mirante,it ITA,GK,Roma,35,1983,2.0,0,0,0,0,0,0,0,,0,0,0,0,0,0,0,0,Matches,2019
429,Matej Mitrović,hr CRO,DF,Club Brugge,24,1993,1.0,2,1,2,0,0,0,0,,0,1,0,1,6,8,7,0,Matches,2019
430,Luka Modrić,hr CRO,MF,Real Madrid,32,1985,5.2,8,4,3,4,1,4,12,33.3,8,1,0,1,7,15,0,0,Matches,2019
431,Francisco Montero,es ESP,DF,Atlético Madrid,19,1999,1.5,0,0,0,0,0,0,1,0.0,1,0,0,0,0,0,11,1,Matches,2019
432,Júnior Moraes,ua UKR,FW,Shakhtar,31,1987,5.6,4,1,1,3,0,0,9,0.0,9,6,1,5,2,6,5,0,Matches,2019
433,Wesley Moraes,br BRA,FW,Club Brugge,21,1996,5.8,2,1,1,0,1,1,1,100.0,0,2,0,2,0,2,5,0,Matches,2019
434,Erik Morán,es ESP,MF,AEK Athens,27,1991,1.1,2,1,1,1,0,2,5,40.0,3,1,1,0,1,3,2,0,Matches,2019
435,Álvaro Morata,es ESP,FW,Atlético Madrid,25,1992,1.4,1,1,1,0,0,0,0,,0,3,0,3,1,2,0,0,Matches,2019
436,Jérémy Morel,mg MAD,DF,Lyon,34,1984,1.0,1,1,0,1,0,0,0,,0,0,0,0,0,1,7,0,Matches,2019
437,Alberto Moreno,es ESP,DF,Liverpool,26,1992,0.1,1,0,1,0,0,0,0,,0,0,0,0,0,1,0,0,Matches,2019
438,Ubong Moses Ekpai,ng NGA,"FW,MF",Viktoria Plzeň,22,1995,0.4,1,0,1,0,0,1,1,100.0,0,1,0,1,0,1,0,0,Matches,2019
439,Lucas Moura,br BRA,FW,Tottenham,25,1992,8.0,12,7,3,6,3,4,7,57.1,3,8,0,8,7,19,1,0,Matches,2019
440,Thomas Müller,de GER,"MF,FW",Bayern Munich,28,1989,3.9,9,6,2,6,1,0,6,0.0,6,9,1,8,5,14,3,0,Matches,2019
441,Jeison Murillo,co COL,DF,Valencia,26,1992,1.0,1,0,1,0,0,0,0,,0,1,1,0,3,4,3,0,Matches,2019
442,Fernando Muslera,uy URU,GK,Galatasaray,32,1986,6.0,0,0,0,0,0,0,0,,0,0,0,0,0,0,2,1,Matches,2019
443,Kévin N'Doram,fr FRA,MF,Monaco,22,1996,1.0,1,1,0,1,0,1,1,100.0,0,0,0,0,2,3,2,0,Matches,2019
444,Kirill Nababkin,ru RUS,DF,CSKA Moscow,31,1986,6.0,13,8,12,1,0,6,16,37.5,10,12,5,7,7,20,22,0,Matches,2019
445,Ben Nabouhane,km COM,FW,Red Star,29,1989,5.7,4,2,3,1,0,2,6,33.3,4,9,0,9,8,12,17,0,Matches,2019
446,Nacho,es ESP,DF,Real Madrid,28,1990,5.0,11,8,9,2,0,7,12,58.3,5,7,2,5,12,23,13,0,Matches,2019
447,Yuto Nagatomo,jp JPN,DF,Galatasaray,31,1986,4.9,7,3,1,4,2,2,4,50.0,2,6,1,5,5,12,10,0,Matches,2019
448,Radja Nainggolan,be BEL,MF,Inter,30,1988,3.1,3,0,0,3,0,0,4,0.0,4,2,0,2,1,4,2,0,Matches,2019
449,Marvelous Nakamba,zw ZIM,MF,Club Brugge,24,1994,4.4,22,8,14,8,0,9,17,52.9,8,12,0,12,15,37,10,0,Matches,2019
450,Naldo,br BRA,DF,Schalke 04,35,1982,4.0,8,2,3,5,0,5,5,100.0,0,7,7,0,5,13,23,0,Matches,2019
451,Matija Nastasić,rs SRB,DF,Schalke 04,25,1993,6.0,20,16,17,3,0,10,15,66.7,5,3,3,0,12,32,27,1,Matches,2019
452,Keylor Navas,cr CRC,GK,Real Madrid,31,1986,3.0,0,0,0,0,0,0,0,,0,0,0,0,0,0,0,0,Matches,2019
453,Badou Ndiaye,sn SEN,MF,Galatasaray,27,1990,4.7,13,10,6,4,3,6,10,60.0,4,7,2,5,2,15,7,0,Matches,2019
454,Tanguy Ndombele,fr FRA,MF,Lyon,21,1996,7.1,19,11,8,10,1,6,10,60.0,4,6,2,4,12,31,7,0,Matches,2019
455,Reiss Nelson,eng ENG,"FW,MF",Hoffenheim,18,1999,1.3,4,1,2,0,2,1,5,20.0,4,3,0,3,1,5,1,0,Matches,2019
456,Wellington Nem,br BRA,FW,Shakhtar,26,1992,0.9,2,2,0,2,0,2,2,100.0,0,1,0,1,1,3,1,0,Matches,2019
457,David Neres,br BRA,FW,Ajax,21,1997,9.4,10,7,1,6,3,5,14,35.7,9,13,0,13,3,13,3,0,Matches,2019
458,Neto,br BRA,GK,Valencia,29,1989,5.0,0,0,0,0,0,0,0,,0,0,0,0,0,0,1,2,Matches,2019
459,Manuel Neuer,de GER,GK,Bayern Munich,32,1986,8.0,0,0,0,0,0,0,1,0.0,1,0,0,0,0,0,4,1,Matches,2019
460,Neymar,br BRA,"MF,FW",Paris S-G,26,1992,5.9,5,3,2,3,0,0,4,0.0,4,2,2,0,2,7,2,0,Matches,2019
461,Moumi Ngamaleu,cm CMR,"FW,MF",Young Boys,24,1994,2.2,7,1,2,3,2,0,4,0.0,4,1,0,1,3,10,4,0,Matches,2019
462,Cyril Ngonge,be BEL,DF,Club Brugge,18,2000,0.8,2,2,1,1,0,2,3,66.7,1,0,0,0,0,2,2,0,Matches,2019
463,Saúl Ñíguez,es ESP,"MF,DF",Atlético Madrid,23,1994,7.0,13,6,4,6,3,3,15,20.0,12,9,1,8,12,25,10,1,Matches,2019
464,Takuma Nishimura,jp JPN,FW,CSKA Moscow,21,1996,0.0,0,0,0,0,0,0,1,0.0,1,0,0,0,0,0,0,0,Matches,2019
465,Rasmus Nissen,dk DEN,DF,Ajax,21,1997,0.1,0,0,0,0,0,0,0,,0,0,0,0,0,0,0,0,Matches,2019
466,Håvard Nordtveit,no NOR,"DF,MF",Hoffenheim,28,1990,2.1,1,0,1,0,0,1,3,33.3,2,5,2,3,2,3,5,0,Matches,2019
467,Jean-Pierre Nsame,cm CMR,FW,Young Boys,25,1993,1.6,6,1,3,1,2,1,1,100.0,0,1,0,1,0,6,1,0,Matches,2019
468,Alexander Nübel,de GER,GK,Schalke 04,21,1996,2.0,0,0,0,0,0,0,0,,0,0,0,0,0,0,1,0,Matches,2019
469,Kasim Nuhu,gh GHA,DF,Hoffenheim,23,1995,1.6,3,1,3,0,0,3,9,33.3,6,4,2,2,3,6,4,0,Matches,2019
470,Steven Nzonzi,fr FRA,MF,Roma,29,1988,6.8,15,8,6,7,2,5,9,55.6,4,7,2,5,5,20,12,0,Matches,2019
471,Jan Oblak,si SVN,GK,Atlético Madrid,25,1993,8.0,0,0,0,0,0,0,0,,0,0,0,0,0,0,1,0,Matches,2019
472,Ivan Oblyakov,ru RUS,"MF,FW",CSKA Moscow,20,1998,5.4,9,8,3,5,1,3,16,18.8,13,6,2,4,7,16,7,0,Matches,2019
473,Bastian Oczipka,de GER,DF,Schalke 04,29,1989,2.0,2,2,2,0,0,0,1,0.0,1,0,0,0,1,3,5,0,Matches,2019
474,Álvaro Odriozola,es ESP,DF,Real Madrid,22,1995,2.5,5,5,5,0,0,4,4,100.0,0,3,2,1,1,6,2,0,Matches,2019
475,Marios Oikonomou,gr GRE,DF,AEK Athens,25,1992,3.7,3,2,3,0,0,1,4,25.0,3,3,2,1,12,15,21,0,Matches,2019
476,Sérgio Oliveira,pt POR,MF,Porto,26,1992,1.1,2,1,1,0,1,1,4,25.0,3,4,1,3,1,3,1,0,Matches,2019
477,Robin Olsen,se SWE,GK,Roma,28,1990,6.3,0,0,0,0,0,0,0,,0,0,0,0,0,0,2,0,Matches,2019
478,André Onana,cm CMR,GK,Ajax,22,1996,12.0,0,0,0,0,0,0,0,,0,0,0,0,0,0,4,3,Matches,2019
479,Henry Onyekuru,ng NGA,"FW,MF",Galatasaray,21,1997,3.6,6,4,0,2,4,1,1,100.0,0,4,0,4,2,8,0,0,Matches,2019
480,Loïs Openda,be BEL,"FW,MF",Club Brugge,18,2000,1.2,1,0,1,0,0,0,1,0.0,1,2,0,2,1,2,3,0,Matches,2019
481,Divock Origi,be BEL,FW,Liverpool,23,1995,2.5,0,0,0,0,0,0,1,0.0,1,1,0,1,1,1,0,0,Matches,2019
482,David Ospina,co COL,GK,Napoli,29,1988,6.0,2,1,2,0,0,2,2,100.0,0,0,0,0,0,2,4,0,Matches,2019
483,Nicolás Otamendi,ar ARG,DF,Manchester City,30,1988,4.4,9,4,4,5,0,7,9,77.8,2,4,3,1,6,15,25,1,Matches,2019
484,Otávio,pt POR,"MF,FW",Porto,23,1995,5.7,20,13,7,9,4,6,15,40.0,9,10,0,10,5,25,5,1,Matches,2019
485,Adam Ounas,dz ALG,"MF,FW",Napoli,21,1996,0.3,0,0,0,0,0,0,1,0.0,1,1,0,1,0,0,0,0,Matches,2019
486,Leandro Paredes,ar ARG,MF,Paris S-G,24,1994,0.4,1,1,1,0,0,0,1,0.0,1,1,0,1,0,1,0,0,Matches,2019
487,Daniel Parejo,es ESP,MF,Valencia,29,1989,5.0,7,4,4,2,1,4,9,44.4,5,7,0,7,2,9,1,0,Matches,2019
488,Thomas Partey,gh GHA,MF,Atlético Madrid,25,1993,4.6,8,6,2,3,3,2,9,22.2,7,5,3,2,11,19,5,0,Matches,2019
489,Javier Pastore,ar ARG,MF,Roma,29,1989,0.6,1,0,0,0,1,0,1,0.0,1,0,0,0,0,1,0,0,Matches,2019
490,Alan Patrick,br BRA,MF,Shakhtar,27,1991,2.3,4,1,2,2,0,1,2,50.0,1,5,2,3,1,5,0,1,Matches,2019
491,Gabriel Paulista,br BRA,DF,Valencia,27,1990,5.0,8,7,5,3,0,2,4,50.0,2,11,5,6,9,17,23,0,Matches,2019
492,Milan Pavkov,rs SRB,FW,Red Star,24,1994,2.4,5,2,1,4,0,0,1,0.0,1,2,0,2,3,8,6,0,Matches,2019
493,Lorenzo Pellegrini,it ITA,MF,Roma,22,1996,4.3,7,4,2,5,0,1,11,9.1,10,8,0,8,5,12,4,0,Matches,2019
494,Luca Pellegrini,it ITA,DF,Roma,19,1999,0.3,3,3,2,1,0,1,1,100.0,0,0,0,0,0,3,1,0,Matches,2019
495,Pepe,pt POR,DF,Porto,35,1983,3.3,7,5,6,1,0,3,7,42.9,4,2,1,1,3,10,7,1,Matches,2019
496,André Pereira,pt POR,"FW,MF",Porto,23,1995,0.7,2,1,2,0,0,2,2,100.0,0,1,0,1,1,3,0,0,Matches,2019
497,Andreas Pereira,br BRA,"MF,FW",Manchester Utd,22,1996,2.1,2,1,0,1,1,1,3,33.3,2,3,0,3,1,3,1,0,Matches,2019
498,Danilo Pereira,pt POR,MF,Porto,26,1991,10.3,14,8,6,8,0,5,12,41.7,7,11,7,4,14,28,13,0,Matches,2019
499,Maxi Pereira,uy URU,DF,Porto,34,1984,7.0,14,12,8,4,2,3,8,37.5,5,7,1,6,8,22,22,0,Matches,2019
500,Gastón Pereiro,uy URU,MF,PSV Eindhoven,23,1995,4.3,5,3,2,2,1,4,9,44.4,5,4,1,3,1,6,8,0,Matches,2019
501,Luan Peres Petroni,br BRA,DF,Club Brugge,24,1994,0.2,1,1,1,0,0,1,1,100.0,0,0,0,0,0,1,2,0,Matches,2019
502,Ivan Perišić,hr CRO,FW,Inter,29,1989,5.5,10,6,4,5,1,5,11,45.5,6,10,1,9,11,21,16,0,Matches,2019
503,Luděk Pernica,cz CZE,DF,Viktoria Plzeň,28,1990,1.0,0,0,0,0,0,0,0,,0,3,1,2,2,2,1,0,Matches,2019
504,Diego Perotti,ar ARG,"FW,MF",Roma,30,1988,1.7,3,3,2,0,1,2,3,66.7,1,3,0,3,3,6,0,0,Matches,2019
505,Milan Petržela,cz CZE,FW,Viktoria Plzeň,35,1983,2.5,7,3,5,2,0,4,8,50.0,4,0,0,0,1,8,0,0,Matches,2019
506,Maximilian Philipp,de GER,FW,Dortmund,24,1994,0.9,2,2,0,1,1,1,1,100.0,0,1,0,1,2,4,0,0,Matches,2019
507,Cristiano Piccini,it ITA,DF,Valencia,25,1992,3.0,10,7,7,3,0,5,6,83.3,1,3,1,2,4,14,9,0,Matches,2019
508,Gerard Piqué,es ESP,DF,Barcelona,31,1987,11.0,12,8,7,5,0,4,8,50.0,4,13,9,4,12,24,56,1,Matches,2019
509,Łukasz Piszczek,pl POL,DF,Dortmund,33,1985,5.0,13,8,7,3,3,8,17,47.1,9,7,2,5,10,23,10,0,Matches,2019
510,Pizzi,pt POR,MF,Benfica,28,1989,3.5,2,2,0,2,0,0,3,0.0,3,5,0,5,2,4,1,0,Matches,2019
511,Miralem Pjanić,ba BIH,MF,Juventus,28,1990,9.0,18,10,10,6,2,7,27,25.9,20,10,1,9,16,34,6,0,Matches,2019
512,Paul Pogba,fr FRA,MF,Manchester Utd,25,1993,8.1,5,2,2,3,0,0,6,0.0,6,12,2,10,6,11,5,0,Matches,2019
513,Matteo Politano,it ITA,FW,Inter,24,1993,5.0,5,4,3,1,1,1,10,10.0,9,1,0,1,3,8,2,0,Matches,2019
514,Ilya Pomazun,ru RUS,GK,CSKA Moscow,21,1996,1.0,0,0,0,0,0,0,0,,0,0,0,0,0,0,0,2,Matches,2019
515,Ezequiel Ponce,ar ARG,FW,AEK Athens,21,1997,5.4,6,5,2,4,0,1,4,25.0,3,1,0,1,2,8,6,1,Matches,2019
516,Stefan Posch,at AUT,DF,Hoffenheim,21,1997,2.0,5,4,3,1,1,1,3,33.3,2,4,1,3,1,6,1,1,Matches,2019
517,Benoît Poulain,fr FRA,DF,Club Brugge,31,1987,6.0,7,4,6,1,0,4,7,57.1,3,9,2,7,15,22,34,0,Matches,2019
518,Roman Procházka,sk SVK,MF,Viktoria Plzeň,29,1989,4.7,8,1,5,3,0,3,14,21.4,11,11,4,7,6,14,8,0,Matches,2019
519,Christian Pulisic,us USA,FW,Dortmund,19,1998,5.0,6,5,2,3,1,1,6,16.7,5,4,0,4,3,9,3,0,Matches,2019
520,Andriy Pyatov,ua UKR,GK,Shakhtar,34,1984,6.0,0,0,0,0,0,0,0,,0,0,0,0,0,0,2,0,Matches,2019
521,Adrien Rabiot,fr FRA,MF,Paris S-G,23,1995,3.2,8,4,4,4,0,2,2,100.0,0,5,0,5,3,11,4,0,Matches,2019
522,Rafael,br BRA,"DF,MF",Lyon,28,1990,2.6,9,3,7,1,1,4,11,36.4,7,5,0,5,11,20,12,1,Matches,2019
523,Rafinha,br BRA,DF,Bayern Munich,32,1985,4.1,15,10,10,5,0,6,13,46.2,7,1,0,1,5,20,8,0,Matches,2019
524,Rafinha,br BRA,FW,Barcelona,25,1993,0.9,2,2,0,1,1,1,1,100.0,0,2,0,2,0,2,0,0,Matches,2019
525,Andrea Raggi,it ITA,DF,Monaco,34,1984,4.0,3,1,3,0,0,0,2,0.0,2,5,1,4,5,8,11,0,Matches,2019
526,Baba Rahman,gh GHA,DF,Schalke 04,24,1994,0.8,3,3,1,1,1,2,2,100.0,0,3,0,3,0,3,3,0,Matches,2019
527,Ivan Rakitić,hr CRO,MF,Barcelona,30,1988,11.3,9,4,3,5,1,3,9,33.3,6,19,3,16,19,28,8,1,Matches,2019
528,Yaroslav Rakitskiy,ua UKR,DF,Shakhtar,28,1989,4.0,1,1,0,1,0,0,1,0.0,1,6,5,1,6,7,16,0,Matches,2019
529,Sergio Ramos,es ESP,DF,Real Madrid,32,1986,4.6,10,8,10,0,0,7,9,77.8,2,3,1,2,13,23,13,0,Matches,2019
530,Marcus Rashford,eng ENG,FW,Manchester Utd,20,1997,8.0,8,6,2,2,4,2,9,22.2,7,8,0,8,2,10,10,0,Matches,2019
531,Sergio Reguilón,es ESP,DF,Real Madrid,21,1996,4.0,7,6,4,3,0,5,7,71.4,2,4,2,2,10,17,8,0,Matches,2019
532,Marco Reus,de GER,"MF,FW",Dortmund,29,1989,5.8,16,8,3,8,5,3,7,42.9,4,8,1,7,11,27,7,0,Matches,2019
533,Kaveh Rezaei,ir IRN,FW,Club Brugge,26,1992,1.1,0,0,0,0,0,0,1,0.0,1,0,0,0,0,0,0,0,Matches,2019
534,Jakub Řezníček,cz CZE,FW,Viktoria Plzeň,30,1988,0.7,1,1,0,1,0,1,1,100.0,0,1,0,1,0,1,0,0,Matches,2019
535,Radim Řezník,cz CZE,DF,Viktoria Plzeň,29,1989,5.0,7,5,3,4,0,4,9,44.4,5,6,1,5,2,9,10,0,Matches,2019
536,Franck Ribéry,fr FRA,"MF,FW",Bayern Munich,35,1983,4.8,7,4,3,3,1,3,12,25.0,9,5,0,5,7,14,1,0,Matches,2019
537,Mats Rits,be BEL,MF,Club Brugge,25,1993,3.0,5,3,5,0,0,2,3,66.7,1,3,1,2,5,10,9,0,Matches,2019
538,Arjen Robben,nl NED,"FW,MF",Bayern Munich,34,1984,3.5,2,0,1,1,0,2,11,18.2,9,2,0,2,2,4,0,0,Matches,2019
539,Sergi Roberto,es ESP,"DF,MF",Barcelona,26,1992,7.8,14,9,8,5,1,7,10,70.0,3,4,0,4,12,26,13,0,Matches,2019
540,Andrew Robertson,sct SCO,DF,Liverpool,24,1994,11.2,30,14,18,9,3,19,28,67.9,9,13,2,11,7,37,25,1,Matches,2019
541,Milan Rodić,rs SRB,DF,Red Star,27,1991,5.0,5,4,3,2,0,2,4,50.0,2,5,4,1,6,11,26,1,Matches,2019
542,Rodri,es ESP,MF,Atlético Madrid,22,1996,6.7,9,7,3,4,2,4,7,57.1,3,9,4,5,12,21,12,0,Matches,2019
543,Rodrigo,es ESP,FW,Valencia,27,1991,4.8,1,0,0,1,0,0,3,0.0,3,1,0,1,1,2,2,0,Matches,2019
544,Garry Rodrigues,cv CPV,"FW,MF",Galatasaray,27,1990,5.7,7,4,3,4,0,0,1,0.0,1,6,0,6,0,7,1,0,Matches,2019
545,James Rodríguez,co COL,MF,Bayern Munich,27,1991,3.7,6,4,4,2,0,2,4,50.0,2,7,0,7,5,11,4,0,Matches,2019
546,Marko Rog,hr CRO,"FW,MF",Napoli,23,1995,0.1,1,0,1,0,0,0,1,0.0,1,1,0,1,0,1,0,0,Matches,2019
547,Marcos Rojo,ar ARG,DF,Manchester Utd,28,1990,0.5,1,1,1,0,0,1,4,25.0,3,0,0,0,0,1,2,0,Matches,2019
548,Maximiliano Romero,ar ARG,FW,PSV Eindhoven,19,1999,0.1,0,0,0,0,0,0,0,,0,0,0,0,0,0,0,0,Matches,2019
549,Sergio Romero,ar ARG,GK,Manchester Utd,31,1987,1.0,0,0,0,0,0,0,0,,0,0,0,0,0,0,2,0,Matches,2019
550,Cristiano Ronaldo,pt POR,FW,Juventus,33,1985,8.3,3,3,1,2,0,0,7,0.0,7,2,1,1,3,6,6,0,Matches,2019
551,Pablo Rosario,nl NED,MF,PSV Eindhoven,21,1997,5.9,16,8,11,5,0,5,13,38.5,8,7,3,4,9,25,16,0,Matches,2019
552,Danny Rose,eng ENG,DF,Tottenham,28,1990,5.9,11,6,4,6,1,6,10,60.0,4,7,3,4,7,18,16,0,Matches,2019
553,Boris Rotenberg,fi FIN,FW,Loko Moscow,32,1986,0.0,0,0,0,0,0,0,0,,0,0,0,0,0,0,0,0,Matches,2019
554,Sebastian Rudy,de GER,MF,Schalke 04,28,1990,2.7,8,4,4,4,0,2,8,25.0,6,0,0,0,5,13,3,0,Matches,2019
555,Daniele Rugani,it ITA,DF,Juventus,24,1994,3.0,2,1,1,1,0,1,2,50.0,1,5,4,1,6,8,11,1,Matches,2019
556,Mário Rui,pt POR,DF,Napoli,27,1991,5.8,8,7,3,5,0,3,8,37.5,5,9,1,8,7,15,23,2,Matches,2019
557,Fabián Ruiz Peña,es ESP,MF,Napoli,22,1996,5.2,11,9,4,6,1,5,8,62.5,3,4,1,3,7,18,7,0,Matches,2019
558,Maciej Rybus,pl POL,DF,Loko Moscow,28,1989,2.0,9,5,8,1,0,5,7,71.4,2,3,0,3,6,15,13,0,Matches,2019
559,Michal Sadílek,cz CZE,MF,PSV Eindhoven,19,1999,0.3,0,0,0,0,0,0,0,,0,2,1,1,1,1,3,0,Matches,2019
560,Trent Sainsbury,au AUS,DF,PSV Eindhoven,26,1992,1.1,1,0,0,1,0,0,0,,0,2,2,0,0,1,16,0,Matches,2019
561,Mohamed Salah,eg EGY,FW,Liverpool,26,1992,11.7,11,3,2,1,8,4,8,50.0,4,3,0,3,4,15,1,1,Matches,2019
562,Eduardo Salvio,ar ARG,"FW,MF",Benfica,28,1990,2.7,5,5,2,3,0,2,7,28.6,5,4,0,4,7,12,4,0,Matches,2019
563,Renato Sanches,pt POR,MF,Bayern Munich,20,1997,1.4,1,0,0,1,0,0,1,0.0,1,0,0,0,1,2,1,1,Matches,2019
564,Alexis Sánchez,cl CHI,FW,Manchester Utd,29,1988,2.3,3,3,1,1,1,0,2,0.0,2,5,2,3,1,4,0,0,Matches,2019
565,Davinson Sánchez,co COL,DF,Tottenham,22,1996,7.0,11,7,8,3,0,3,7,42.9,4,5,4,1,11,22,26,0,Matches,2019
566,Javi Sánchez,es ESP,DF,Real Madrid,21,1997,1.4,2,1,2,0,0,2,3,66.7,1,2,1,1,0,2,8,0,Matches,2019
567,Jadon Sancho,eng ENG,"FW,MF",Dortmund,18,2000,4.8,4,3,0,4,0,1,2,50.0,1,7,0,7,1,5,2,0,Matches,2019
568,Alex Sandro,br BRA,DF,Juventus,27,1991,8.3,16,8,12,2,2,8,14,57.1,6,10,4,6,11,27,19,0,Matches,2019
569,Leroy Sané,de GER,"FW,DF",Manchester City,22,1996,4.4,6,5,0,4,2,1,6,16.7,5,3,1,2,2,8,2,0,Matches,2019
570,Salif Sané,sn SEN,DF,Schalke 04,27,1990,6.0,7,5,6,1,0,2,7,28.6,5,9,5,4,12,19,23,1,Matches,2019
571,Sékou Sanogo,ci CIV,MF,Young Boys,29,1989,3.3,7,1,3,3,1,2,6,33.3,4,3,0,3,6,13,2,0,Matches,2019
572,Davide Santon,it ITA,DF,Roma,27,1991,2.9,6,5,3,3,0,4,7,57.1,3,2,0,2,7,13,13,0,Matches,2019
573,Stefan Savić,me MNE,DF,Atlético Madrid,27,1991,0.9,1,1,0,1,0,1,1,100.0,0,2,1,1,0,1,1,0,Matches,2019
574,Vujadin Savić,rs SRB,DF,Red Star,28,1990,2.5,3,0,3,0,0,1,2,50.0,1,2,2,0,7,10,30,0,Matches,2019
575,Patrik Schick,cz CZE,FW,Roma,22,1996,2.8,2,1,1,1,0,0,2,0.0,2,1,1,0,1,3,3,0,Matches,2019
576,Thorsten Schick,at AUT,"DF,FW",Young Boys,28,1990,1.1,3,1,1,1,1,2,2,100.0,0,0,0,0,2,5,2,0,Matches,2019
577,Marcel Schmelzer,de GER,DF,Dortmund,30,1988,2.2,4,2,3,1,0,1,1,100.0,0,5,2,3,2,6,7,0,Matches,2019
578,Lasse Schöne,dk DEN,MF,Ajax,32,1986,9.8,22,7,10,11,1,11,25,44.0,14,8,1,7,16,38,13,0,Matches,2019
579,Alessandro Schöpf,at AUT,"DF,FW",Schalke 04,24,1994,3.3,4,1,2,2,0,3,7,42.9,4,4,0,4,5,9,3,0,Matches,2019
580,Siebe Schrijvers,be BEL,FW,Club Brugge,22,1996,0.8,1,0,1,0,0,0,0,,0,1,0,1,0,1,0,0,Matches,2019
581,Nico Schulz,de GER,"DF,MF",Hoffenheim,25,1993,4.9,11,6,5,4,2,5,7,71.4,2,3,1,2,6,17,6,2,Matches,2019
582,Daniel Schwaab,de GER,DF,PSV Eindhoven,29,1988,5.0,8,4,8,0,0,2,6,33.3,4,6,6,0,10,18,28,0,Matches,2019
583,Haris Seferović,ch SUI,FW,Benfica,26,1992,4.8,0,0,0,0,0,0,1,0.0,1,2,0,2,1,1,3,0,Matches,2019
584,Alfa Semedo,gw GNB,"MF,FW",Benfica,20,1997,1.5,3,2,1,2,0,2,5,40.0,3,3,0,3,4,7,4,0,Matches,2019
585,Nélson Semedo,pt POR,DF,Barcelona,24,1993,6.2,16,12,7,8,1,9,14,64.3,5,8,0,8,6,22,10,2,Matches,2019
586,Suat Serdar,de GER,MF,Schalke 04,21,1997,5.6,15,11,5,9,1,7,13,53.8,6,7,0,7,6,21,0,0,Matches,2019
587,Julien Serrano,fr FRA,DF,Monaco,20,1998,0.1,0,0,0,0,0,0,0,,0,0,0,0,0,0,0,0,Matches,2019
588,Stephan El Shaarawy,it ITA,FW,Roma,25,1992,2.9,4,2,3,1,0,1,4,25.0,3,0,0,0,3,7,3,0,Matches,2019
589,Xherdan Shaqiri,ch SUI,"FW,MF",Liverpool,26,1991,2.0,1,0,0,0,1,0,2,0.0,2,3,0,3,1,2,2,0,Matches,2019
590,Luke Shaw,eng ENG,DF,Manchester Utd,23,1995,8.0,15,10,8,7,0,9,12,75.0,3,11,1,10,9,24,18,0,Matches,2019
591,Georgi Shchennikov,ru RUS,"DF,FW",CSKA Moscow,27,1991,2.4,3,2,1,2,0,1,2,50.0,1,2,0,2,2,5,8,0,Matches,2019
592,Djibril Sidibé,fr FRA,"DF,MF",Monaco,26,1992,3.7,13,7,4,9,0,3,6,50.0,3,5,0,5,3,16,3,0,Matches,2019
593,Arnór Sigurðsson,is ISL,"MF,FW",CSKA Moscow,19,1999,3.9,3,2,3,0,0,0,6,0.0,6,4,0,4,1,4,3,0,Matches,2019
594,Bernardo Silva,pt POR,"MF,FW",Manchester City,23,1994,6.4,15,6,5,7,3,4,14,28.6,10,4,1,3,8,23,2,0,Matches,2019
595,David Silva,es ESP,MF,Manchester City,32,1986,7.9,11,6,2,6,3,1,6,16.7,5,8,0,8,7,18,4,0,Matches,2019
596,Rafa Silva,pt POR,"FW,MF",Benfica,25,1993,4.1,14,8,5,9,0,7,13,53.8,6,3,0,3,4,18,7,0,Matches,2019
597,Thiago Silva,br BRA,DF,Paris S-G,33,1984,6.8,7,4,4,3,0,1,3,33.3,2,12,6,6,11,18,47,0,Matches,2019
598,Veljko Simić,rs SRB,FW,Red Star,23,1995,2.3,3,2,1,1,1,0,3,0.0,3,1,0,1,1,4,0,0,Matches,2019
599,André Simões,pt POR,MF,AEK Athens,28,1989,3.9,8,8,3,5,0,5,9,55.6,4,9,6,3,3,11,3,0,Matches,2019
600,Daley Sinkgraven,nl NED,"DF,FW",Ajax,23,1995,1.1,4,2,2,1,1,2,3,66.7,1,2,0,2,0,4,3,0,Matches,2019
601,Moussa Sissoko,fr FRA,MF,Tottenham,28,1989,8.1,20,16,11,8,1,7,15,46.7,8,2,1,1,10,30,5,0,Matches,2019
602,Milan Škriniar,sk SVK,DF,Inter,23,1995,6.0,24,18,19,5,0,14,22,63.6,8,3,2,1,2,26,25,0,Matches,2019
603,Steven Skrzybski,de GER,"FW,MF",Schalke 04,25,1992,1.1,2,1,0,2,0,1,6,16.7,5,0,0,0,1,3,0,0,Matches,2019
604,Chris Smalling,eng ENG,DF,Manchester Utd,28,1989,8.0,12,8,10,1,1,7,9,77.8,2,11,8,3,9,21,40,0,Matches,2019
605,Fyodor Smolov,ru RUS,FW,Loko Moscow,28,1990,1.3,1,1,0,1,0,0,1,0.0,1,1,1,0,0,1,1,0,Matches,2019
606,Tiquinho Soares,br BRA,FW,Porto,27,1991,3.0,3,3,2,0,1,2,4,50.0,2,4,1,3,1,4,1,0,Matches,2019
607,Carlos Soler,es ESP,MF,Valencia,21,1997,4.4,14,11,8,4,2,6,8,75.0,2,4,1,3,1,15,2,0,Matches,2019
608,Djibril Sow,ch SUI,MF,Young Boys,21,1997,5.6,12,6,5,6,1,4,8,50.0,4,7,2,5,9,21,10,0,Matches,2019
609,Leonardo Spinazzola,it ITA,DF,Juventus,25,1993,0.7,1,1,0,0,1,0,0,,0,1,0,1,0,1,0,0,Matches,2019
610,Slavoljub Srnić,rs SRB,"FW,MF",Red Star,26,1992,2.7,4,1,2,1,1,0,1,0.0,1,3,0,3,1,5,4,0,Matches,2019
611,Benjamin Stambouli,fr FRA,DF,Schalke 04,27,1990,4.8,22,13,13,8,1,13,16,81.3,3,9,1,8,11,33,9,0,Matches,2019
612,Taras Stepanenko,ua UKR,MF,Shakhtar,28,1989,5.8,14,11,5,8,1,6,18,33.3,12,9,5,4,6,20,6,0,Matches,2019
613,Raheem Sterling,eng ENG,FW,Manchester City,23,1994,9.7,10,4,4,2,4,4,16,25.0,12,6,0,6,7,17,5,0,Matches,2019
614,Nikola Stojiljković,rs SRB,FW,Red Star,25,1992,0.5,0,0,0,0,0,0,0,,0,0,0,0,0,0,0,0,Matches,2019
615,Filip Stojković,me MNE,DF,Red Star,25,1993,4.6,7,6,6,1,0,4,13,30.8,9,6,5,1,13,20,13,0,Matches,2019
616,John Stones,eng ENG,DF,Manchester City,24,1994,4.7,5,3,2,3,0,3,3,100.0,0,6,3,3,7,12,13,0,Matches,2019
617,Daniel Sturridge,eng ENG,FW,Liverpool,28,1989,2.3,0,0,0,0,0,0,0,,0,1,1,0,1,1,0,0,Matches,2019
618,Denis Suárez,es ESP,FW,Barcelona,24,1994,0.3,0,0,0,0,0,0,0,,0,0,0,0,0,0,0,0,Matches,2019
619,Luis Suárez,uy URU,FW,Barcelona,31,1987,10.0,7,4,0,3,4,3,13,23.1,10,3,0,3,1,8,9,0,Matches,2019
620,Danijel Subašić,hr CRO,GK,Monaco,33,1984,0.5,0,0,0,0,0,0,1,0.0,1,0,0,0,0,0,0,0,Matches,2019
621,Niklas Süle,de GER,DF,Bayern Munich,22,1995,5.0,6,5,3,3,0,2,3,66.7,1,9,3,6,9,15,19,0,Matches,2019
622,Miralem Sulejmani,rs SRB,"MF,FW",Young Boys,29,1988,3.8,3,2,3,0,0,0,7,0.0,7,1,0,1,1,4,1,0,Matches,2019
623,Moussa Sylla,fr FRA,FW,Monaco,18,1999,3.8,1,0,1,0,0,0,0,,0,1,0,1,2,3,2,0,Matches,2019
624,Ádám Szalai,hu HUN,"FW,MF",Hoffenheim,30,1987,3.0,3,1,1,1,1,0,1,0.0,1,2,1,1,0,3,1,0,Matches,2019
625,Wojciech Szczęsny,pl POL,GK,Juventus,28,1990,10.0,0,0,0,0,0,0,1,0.0,1,0,0,0,0,0,6,0,Matches,2019
626,Dušan Tadić,rs SRB,FW,Ajax,29,1988,12.0,12,7,3,4,5,2,16,12.5,14,15,1,14,6,18,6,0,Matches,2019
627,Nicolás Tagliafico,ar ARG,DF,Ajax,25,1992,10.0,36,20,9,20,7,14,27,51.9,13,17,3,14,20,56,27,1,Matches,2019
628,Taison,br BRA,"FW,MF",Shakhtar,30,1988,4.8,7,6,2,3,2,2,3,66.7,1,3,1,2,2,9,4,0,Matches,2019
629,Alex Telles,br BRA,DF,Porto,25,1992,10.3,12,7,7,4,1,3,11,27.3,8,12,5,7,16,28,32,0,Matches,2019
630,Marc-André ter Stegen,de GER,GK,Barcelona,26,1992,11.0,0,0,0,0,0,0,0,,0,0,0,0,0,0,3,3,Matches,2019
631,Martin Terrier,fr FRA,"FW,MF",Lyon,21,1997,1.8,1,1,0,1,0,1,2,50.0,1,4,0,4,2,3,1,0,Matches,2019
632,Kenny Tete,nl NED,DF,Lyon,22,1995,2.2,12,9,3,8,1,5,5,100.0,0,5,0,5,4,16,7,0,Matches,2019
633,Cedric Teuchert,de GER,FW,Schalke 04,21,1997,0.9,1,0,0,1,0,0,0,,0,0,0,0,0,1,1,0,Matches,2019
634,Khéphren Thuram,fr FRA,MF,Monaco,17,2001,0.6,3,2,1,2,0,1,2,50.0,1,0,0,0,0,3,0,0,Matches,2019
635,Youri Tielemans,be BEL,MF,Monaco,21,1997,6.0,14,9,6,6,2,5,12,41.7,7,7,2,5,10,24,7,1,Matches,2019
636,Ömer Toprak,tr TUR,DF,Dortmund,29,1989,3.0,5,3,5,0,0,2,2,100.0,0,2,2,0,4,9,10,0,Matches,2019
637,Ferrán Torres,es ESP,MF,Valencia,18,2000,1.2,2,1,1,1,0,0,0,,0,0,0,0,0,2,2,0,Matches,2019
638,Óliver Torres,es ESP,MF,Porto,23,1994,3.9,12,7,6,4,2,7,16,43.8,9,6,1,5,6,18,2,0,Matches,2019
639,Almamy Touré,ml MLI,DF,Monaco,22,1996,0.2,0,0,0,0,0,0,0,,0,0,0,0,2,2,2,0,Matches,2019
640,Lucas Tousart,fr FRA,MF,Lyon,21,1997,5.4,21,13,8,13,0,7,21,33.3,14,10,3,7,4,25,10,0,Matches,2019
641,Adama Traoré,ml MLI,"FW,MF",Monaco,23,1995,0.2,0,0,0,0,0,0,1,0.0,1,0,0,0,1,1,0,0,Matches,2019
642,Bertrand Traoré,bf BFA,"FW,MF",Lyon,22,1995,3.6,6,3,3,2,1,3,3,100.0,0,4,1,3,2,8,4,0,Matches,2019
643,Kieran Trippier,eng ENG,DF,Tottenham,27,1990,6.9,17,10,11,5,1,8,15,53.3,7,7,1,6,11,28,11,1,Matches,2019
644,Samuel Umtiti,fr FRA,DF,Barcelona,24,1993,0.9,1,1,0,1,0,0,0,,0,2,1,1,0,1,0,0,Matches,2019
645,Cengiz Ünder,tr TUR,"FW,MF",Roma,21,1997,4.8,2,2,2,0,0,0,2,0.0,2,3,0,3,3,5,0,0,Matches,2019
646,Mark Uth,de GER,"FW,MF",Schalke 04,26,1991,4.4,10,6,2,5,3,0,13,0.0,13,7,1,6,5,15,4,0,Matches,2019
647,Antonio Valencia,ec ECU,DF,Manchester Utd,32,1985,2.8,3,2,1,1,1,2,3,66.7,1,2,1,1,8,11,7,0,Matches,2019
648,Borja Valero,es ESP,MF,Inter,33,1985,2.6,2,1,1,0,1,2,7,28.6,5,1,0,1,2,4,0,0,Matches,2019
649,Jesús Vallejo,es ESP,DF,Real Madrid,21,1997,1.0,1,1,1,0,0,1,1,100.0,0,2,1,1,3,4,4,0,Matches,2019
650,Federico Valverde,uy URU,MF,Real Madrid,20,1998,1.6,5,5,3,2,0,4,8,50.0,4,3,0,3,5,10,2,0,Matches,2019
651,Virgil van Dijk,nl NED,DF,Liverpool,27,1991,12.0,12,8,4,7,1,3,3,100.0,0,9,7,2,10,22,58,2,Matches,2019
652,Hans Vanaken,be BEL,"MF,FW",Club Brugge,25,1992,6.0,16,9,5,9,2,2,14,14.3,12,3,0,3,4,20,4,0,Matches,2019
653,Raphaël Varane,fr FRA,DF,Real Madrid,25,1993,4.0,3,2,1,1,1,0,1,0.0,1,10,2,8,6,9,11,0,Matches,2019
654,Lucas Vázquez,es ESP,"FW,DF",Real Madrid,27,1991,4.3,12,10,3,6,3,5,7,71.4,2,4,0,4,1,13,2,0,Matches,2019
655,Matías Vecino,uy URU,MF,Inter,26,1991,5.0,15,8,6,8,1,5,17,29.4,12,7,2,5,4,19,7,0,Matches,2019
656,Joël Veltman,nl NED,DF,Ajax,26,1992,3.5,14,8,10,4,0,8,11,72.7,3,5,2,3,9,23,6,0,Matches,2019
657,Simone Verdi,it ITA,MF,Napoli,26,1992,0.3,0,0,0,0,0,0,0,,0,0,0,0,0,0,0,0,Matches,2019
658,Thomas Vermaelen,be BEL,DF,Barcelona,32,1985,1.0,0,0,0,0,0,0,1,0.0,1,1,1,0,1,1,6,0,Matches,2019
659,Marco Verratti,it ITA,MF,Paris S-G,25,1992,6.6,25,16,8,12,5,9,20,45.0,11,10,3,7,5,30,5,0,Matches,2019
660,Jan Vertonghen,be BEL,DF,Tottenham,31,1987,9.4,12,3,6,6,0,4,8,50.0,4,7,7,0,18,30,33,0,Matches,2019
661,Rúben Vezo,pt POR,DF,Valencia,24,1994,1.7,2,2,1,1,0,1,4,25.0,3,3,0,3,4,6,8,0,Matches,2019
662,Arturo Vidal,cl CHI,MF,Barcelona,31,1987,4.0,25,12,13,10,2,5,13,38.5,8,8,1,7,10,35,5,0,Matches,2019
663,Nick Viergever,nl NED,DF,PSV Eindhoven,28,1989,5.7,4,2,3,1,0,1,3,33.3,2,10,9,1,6,10,37,0,Matches,2019
664,Vitolo,es ESP,MF,Atlético Madrid,28,1989,1.1,1,1,0,1,0,0,1,0.0,1,0,0,0,2,3,2,0,Matches,2019
665,Odisseas Vlachodimos,gr GRE,GK,Benfica,24,1994,6.0,0,0,0,0,0,0,1,0.0,1,0,0,0,1,1,3,0,Matches,2019
666,Nikola Vlašić,hr CRO,MF,CSKA Moscow,20,1997,6.0,14,7,6,6,2,2,10,20.0,8,9,2,7,4,18,9,0,Matches,2019
667,Thibault Vlietinck,be BEL,"FW,DF",Club Brugge,20,1997,2.3,4,2,2,0,2,1,2,50.0,1,1,0,1,1,5,5,0,Matches,2019
668,Kevin Vogt,de GER,DF,Hoffenheim,26,1991,4.0,4,1,4,0,0,4,5,80.0,1,6,4,2,3,7,15,1,Matches,2019
669,Michel Vorm,nl NED,GK,Tottenham,34,1983,1.1,0,0,0,0,0,0,0,,0,0,0,0,0,0,1,0,Matches,2019
670,Ruud Vormer,nl NED,MF,Club Brugge,30,1988,6.0,12,6,7,5,0,2,6,33.3,4,10,1,9,7,19,9,0,Matches,2019
671,Jelle Vossen,be BEL,FW,Club Brugge,29,1989,0.9,1,1,0,1,0,0,0,,0,1,0,1,2,3,0,0,Matches,2019
672,Stefan de Vrij,nl NED,DF,Inter,26,1992,4.9,6,3,4,2,0,4,4,100.0,0,8,6,2,7,13,18,1,Matches,2019
673,Šime Vrsaljko,hr CRO,DF,Inter,26,1992,1.1,1,0,1,0,0,1,1,100.0,0,0,0,0,3,4,5,0,Matches,2019
674,Sandro Wagner,de GER,"FW,MF",Bayern Munich,30,1987,0.2,1,0,1,0,0,0,2,0.0,2,0,0,0,0,1,0,0,Matches,2019
675,Kyle Walker,eng ENG,DF,Manchester City,28,1990,8.3,4,1,1,2,1,1,4,25.0,3,8,2,6,6,10,15,1,Matches,2019
676,Kyle Walker-Peters,eng ENG,DF,Tottenham,21,1997,0.7,0,0,0,0,0,0,2,0.0,2,2,1,1,0,0,0,1,Matches,2019
677,Victor Wanyama,ke KEN,MF,Tottenham,27,1991,3.2,7,3,4,3,0,2,5,40.0,3,10,1,9,4,11,6,0,Matches,2019
678,Daniel Wass,dk DEN,"DF,MF",Valencia,29,1989,3.0,4,2,3,1,0,3,7,42.9,4,1,1,0,4,8,3,0,Matches,2019
679,Julian Weigl,de GER,"MF,DF",Dortmund,22,1995,3.2,10,6,3,6,1,5,7,71.4,2,2,0,2,3,13,3,0,Matches,2019
680,Georginio Wijnaldum,nl NED,MF,Liverpool,27,1990,10.8,12,6,4,4,4,4,9,44.4,5,7,1,6,2,14,4,0,Matches,2019
681,Harry Winks,eng ENG,MF,Tottenham,22,1996,7.5,16,8,1,13,2,8,11,72.7,3,8,3,5,7,23,6,1,Matches,2019
682,Dani de Wit,nl NED,MF,Ajax,20,1998,0.4,3,1,1,2,0,1,1,100.0,0,0,0,0,0,3,1,0,Matches,2019
683,Axel Witsel,be BEL,MF,Dortmund,29,1989,7.0,11,9,5,6,0,5,9,55.6,4,8,2,6,7,18,6,0,Matches,2019
684,Maximilian Wöber,at AUT,DF,Ajax,20,1998,2.8,3,3,3,0,0,1,1,100.0,0,1,0,1,10,13,17,0,Matches,2019
685,Marius Wolf,de GER,"FW,DF",Dortmund,23,1995,2.3,9,9,1,8,0,1,2,50.0,1,1,0,1,3,12,7,0,Matches,2019
686,Marco Wölfli,ch SUI,GK,Young Boys,35,1982,2.0,1,0,1,0,0,0,1,0.0,1,0,0,0,0,1,1,0,Matches,2019
687,Jeong Woo-yeong,kr KOR,MF,Bayern Munich,18,1999,0.1,0,0,0,0,0,0,0,,0,0,0,0,1,1,0,0,Matches,2019
688,Gregory Wüthrich,ch SUI,MF,Young Boys,23,1994,0.0,0,0,0,0,0,0,0,,0,0,0,0,0,0,0,0,Matches,2019
689,Dmitry Yefremov,ru RUS,DF,CSKA Moscow,23,1995,1.3,3,1,2,1,0,1,3,33.3,2,2,0,2,2,5,9,0,Matches,2019
690,Ashley Young,eng ENG,DF,Manchester Utd,33,1985,6.5,11,5,5,6,0,5,6,83.3,1,4,2,2,7,18,16,0,Matches,2019
691,Dan-Axel Zagadou,fr FRA,DF,Dortmund,19,1999,3.8,4,2,1,3,0,1,3,33.3,2,5,4,1,3,7,16,2,Matches,2019
692,Nicolò Zaniolo,it ITA,"MF,FW",Roma,19,1999,4.3,5,3,0,3,2,2,6,33.3,4,3,0,3,1,6,0,0,Matches,2019
693,Martin Zeman,cz CZE,FW,Viktoria Plzeň,29,1989,0.8,0,0,0,0,0,0,0,,0,0,0,0,0,0,1,0,Matches,2019
694,Timur Zhamaletdinov,ru RUS,FW,CSKA Moscow,21,1997,0.3,0,0,0,0,0,0,0,,0,0,0,0,1,1,0,0,Matches,2019
695,Rifat Zhemaletdinov,ru RUS,FW,Loko Moscow,21,1996,0.4,0,0,0,0,0,0,2,0.0,2,1,0,1,0,0,0,0,Matches,2019
696,Piotr Zieliński,pl POL,"MF,FW",Napoli,24,1994,2.1,0,0,0,0,0,0,0,,0,0,0,0,0,0,1,0,Matches,2019
697,Oleksandr Zinchenko,ua UKR,DF,Manchester City,21,1996,3.7,8,7,2,4,2,3,6,50.0,3,6,1,5,11,19,9,0,Matches,2019
698,Andrija Živković,rs SRB,"FW,MF",Benfica,22,1996,0.8,0,0,0,0,0,0,1,0.0,1,3,0,3,1,1,1,0,Matches,2019
699,Hakim Ziyech,ma MAR,FW,Ajax,25,1993,10.9,28,17,7,14,7,10,33,30.3,23,14,1,13,14,42,6,0,Matches,2019
700,Jeroen Zoet,nl NED,GK,PSV Eindhoven,27,1991,6.0,0,0,0,0,0,0,1,0.0,1,0,0,0,0,0,2,2,Matches,2019
701,Steven Zuber,ch SUI,"FW,MF",Hoffenheim,26,1991,1.1,2,1,0,1,1,0,0,,0,1,0,1,0,2,1,0,Matches,2019
1,Vincent Aboubakar,cm CMR,FW,Porto,25,1992,5.5,1,0,1,0,0,0,0,,0,0,0,0,0,1,1,0,Matches,2018
2,Marcos Acuña,ar ARG,"FW,DF",Sporting CP,25,1991,4.8,7,5,3,3,1,0,2,0.0,2,4,0,4,8,15,3,0,Matches,2018
3,Tosin Adarabioyo,eng ENG,DF,Manchester City,19,1997,1.0,0,0,0,0,0,0,1,0.0,1,0,0,0,2,2,3,0,Matches,2018
4,Adriano,br BRA,DF,Beşiktaş,32,1984,5.4,15,12,5,9,1,8,13,61.5,5,2,0,2,11,26,19,2,Matches,2018
5,Luiz Adriano,br BRA,"FW,MF",Spartak Moscow,30,1987,6.0,8,6,2,3,3,1,4,25.0,3,5,1,4,1,9,16,0,Matches,2018
6,Ansi Agolli,al ALB,DF,Qarabağ FK,34,1982,4.0,7,5,6,1,0,2,2,100.0,0,5,1,4,6,13,15,0,Matches,2018
7,Sergio Agüero,ar ARG,FW,Manchester City,29,1988,4.9,3,2,1,1,1,0,3,0.0,3,4,0,4,3,6,0,0,Matches,2018
8,Karim El Ahmadi,ma MAR,MF,Feyenoord,32,1985,4.0,9,6,4,5,0,1,6,16.7,5,10,0,10,3,12,4,0,Matches,2018
9,Valon Ahmedi,al ALB,"MF,FW",NK Maribor,22,1994,2.5,2,1,1,1,0,2,4,50.0,2,1,0,1,0,2,2,0,Matches,2018
10,Albian Ajeti,ch SUI,FW,Basel,20,1997,1.1,1,0,0,1,0,0,1,0.0,1,0,0,0,0,1,0,0,Matches,2018
11,Manuel Akanji,ch SUI,DF,Basel,22,1995,6.0,8,5,8,0,0,4,11,36.4,7,11,5,6,13,21,32,0,Matches,2018
12,Igor Akinfeev,ru RUS,GK,CSKA Moscow,31,1986,6.0,0,0,0,0,0,0,0,,0,0,0,0,1,1,4,1,Matches,2018
13,David Alaba,at AUT,DF,Bayern Munich,25,1992,6.9,7,5,3,2,2,2,5,40.0,3,5,2,3,7,14,9,2,Matches,2018
14,Jordi Alba,es ESP,DF,Barcelona,28,1989,7.1,12,6,7,4,1,5,13,38.5,8,9,3,6,10,22,15,0,Matches,2018
15,Raúl Albiol,es ESP,DF,Napoli,31,1985,5.0,8,5,7,1,0,5,6,83.3,1,6,5,1,6,14,16,1,Matches,2018
16,Paco Alcácer,es ESP,FW,Barcelona,23,1993,1.1,1,0,1,0,0,0,0,,0,2,0,2,2,3,0,0,Matches,2018
17,Thiago Alcántara,es ESP,MF,Bayern Munich,26,1991,6.7,26,19,7,16,3,8,19,42.1,11,12,1,11,14,40,2,0,Matches,2018
18,Toby Alderweireld,be BEL,DF,Tottenham,28,1989,3.3,6,5,3,3,0,4,6,66.7,2,5,2,3,2,8,20,0,Matches,2018
19,Trent Alexander-Arnold,eng ENG,DF,Liverpool,18,1998,9.1,25,14,16,8,1,16,28,57.1,12,4,2,2,22,47,27,1,Matches,2018
20,Nektarios Alexandrou,cy CYP,"DF,MF",APOEL FC,33,1983,0.6,1,1,0,1,0,0,1,0.0,1,1,1,0,1,2,2,0,Matches,2018
21,Alisson,br BRA,GK,Roma,24,1992,12.0,1,1,1,0,0,0,1,0.0,1,0,0,0,1,2,7,1,Matches,2018
22,Allan,br BRA,MF,Napoli,26,1991,3.4,8,5,1,5,2,2,13,15.4,11,7,0,7,3,11,2,0,Matches,2018
23,Dele Alli,eng ENG,"MF,FW",Tottenham,21,1996,4.8,11,6,3,6,2,1,5,20.0,4,2,0,2,1,12,1,0,Matches,2018
24,André Almeida,pt POR,DF,Benfica,26,1990,2.9,6,4,2,2,2,5,5,100.0,0,2,1,1,4,10,3,0,Matches,2018
25,André Almeida Pinto,pt POR,DF,Sporting CP,27,1989,2.0,3,2,1,2,0,2,2,100.0,0,4,3,1,2,5,5,0,Matches,2018
26,Richard Almeida,az AZE,MF,Qarabağ FK,28,1989,6.0,12,5,5,6,1,2,15,13.3,13,3,1,2,4,16,5,0,Matches,2018
27,Stathis Aloneftis,cy CYP,"FW,MF",APOEL FC,34,1983,5.6,9,7,4,4,1,3,18,16.7,15,6,0,6,10,19,8,0,Matches,2018
28,Marcos Alonso,es ESP,"DF,MF",Chelsea,26,1990,6.6,13,10,6,5,2,6,14,42.9,8,11,1,10,12,25,11,0,Matches,2018
29,Éder Álvarez Balanta,co COL,DF,Basel,24,1993,5.9,14,9,11,3,0,5,12,41.7,7,9,4,5,12,26,33,0,Matches,2018
30,Dani Alves,br BRA,DF,Paris S-G,34,1983,8.0,24,15,14,7,3,7,18,38.9,11,13,2,11,13,37,14,1,Matches,2018
31,Sofyan Amrabat,ma MAR,"MF,DF",Feyenoord,20,1996,5.9,12,12,7,4,1,1,9,11.1,8,9,0,9,9,21,4,1,Matches,2018
32,André André,pt POR,"MF,FW",Porto,27,1989,2.5,6,3,4,2,0,1,3,33.3,2,4,1,3,2,8,4,0,Matches,2018
33,Thanasis Androutsos,gr GRE,FW,Olympiacos,20,1997,1.0,1,0,1,0,0,1,5,20.0,4,1,0,1,0,1,1,0,Matches,2018
34,Minas Antoniou,cy CYP,FW,APOEL FC,23,1994,0.1,2,2,1,1,0,2,2,100.0,0,0,0,0,0,2,0,0,Matches,2018
35,Mirko Antonucci,it ITA,FW,Roma,18,1999,0.2,0,0,0,0,0,0,0,,0,0,0,0,0,0,0,0,Matches,2018
36,Dennis Appiah,fr FRA,"DF,MF",Anderlecht,25,1992,5.7,18,13,10,8,0,10,20,50.0,10,10,1,9,6,24,14,1,Matches,2018
37,Alphonse Areola,fr FRA,GK,Paris S-G,24,1993,8.0,0,0,0,0,0,0,0,,0,0,0,0,0,0,5,0,Matches,2018
38,Stuart Armstrong,sct SCO,MF,Celtic,25,1992,2.6,6,1,0,6,0,0,9,0.0,9,2,0,2,5,11,1,0,Matches,2018
39,Tolgay Arslan,de GER,MF,Beşiktaş,26,1990,3.6,15,11,4,11,0,4,15,26.7,11,6,0,6,4,19,1,0,Matches,2018
40,Kwadwo Asamoah,gh GHA,DF,Juventus,28,1988,1.1,2,2,2,0,0,1,3,33.3,2,2,1,1,2,4,3,0,Matches,2018
41,Marco Asensio,es ESP,"MF,FW",Real Madrid,21,1996,5.2,4,3,2,1,1,0,4,0.0,4,2,1,1,3,7,5,0,Matches,2018
42,Pierre-Emerick Aubameyang,ga GAB,FW,Dortmund,28,1989,6.0,1,0,0,0,1,0,2,0.0,2,3,0,3,0,1,0,0,Matches,2018
43,Jean-Kévin Augustin,fr FRA,FW,RB Leipzig,20,1997,3.8,0,0,0,0,0,0,0,,0,6,0,6,1,1,0,0,Matches,2018
44,Filipe Augusto,br BRA,MF,Benfica,23,1993,2.6,4,3,0,4,0,1,4,25.0,3,4,1,3,5,9,1,0,Matches,2018
45,Serge Aurier,ci CIV,DF,Tottenham,24,1992,5.6,8,7,6,1,1,4,12,33.3,8,3,1,2,17,25,13,0,Matches,2018
46,Márcio Azevedo,br BRA,DF,Shakhtar,31,1986,0.3,0,0,0,0,0,0,1,0.0,1,0,0,0,0,0,0,0,Matches,2018
47,César Azpilicueta,es ESP,DF,Chelsea,27,1989,7.8,13,8,4,7,2,8,14,57.1,6,10,6,4,17,30,14,0,Matches,2018
48,Ryan Babel,nl NED,FW,Beşiktaş,30,1986,6.2,4,1,3,0,1,0,4,0.0,4,4,0,4,7,11,3,0,Matches,2018
49,Eric Bailly,ci CIV,DF,Manchester Utd,23,1994,3.0,8,4,5,3,0,2,2,100.0,0,6,4,2,2,10,10,2,Matches,2018
50,Gregor Bajde,si SVN,"MF,FW",NK Maribor,23,1994,2.8,9,4,6,2,1,4,11,36.4,7,3,0,3,3,12,4,0,Matches,2018
51,Tiemoué Bakayoko,fr FRA,MF,Chelsea,22,1994,4.0,12,11,3,6,3,2,6,33.3,4,3,0,3,7,19,2,0,Matches,2018
52,Keita Baldé,sn SEN,"FW,MF",Monaco,22,1995,3.2,0,0,0,0,0,0,2,0.0,2,0,0,0,1,1,0,0,Matches,2018
53,Gareth Bale,wls WAL,"FW,MF",Real Madrid,28,1989,3.3,2,1,0,1,1,1,1,100.0,0,3,0,3,1,3,6,0,Matches,2018
54,Éver Banega,ar ARG,MF,Sevilla,29,1988,8.8,13,9,2,9,2,6,22,27.3,16,5,2,3,6,19,2,0,Matches,2018
55,Gabriel Barbosa,br BRA,"MF,DF",Benfica,20,1996,0.3,2,2,0,2,0,0,0,,0,0,0,0,1,3,0,0,Matches,2018
56,Marc Bartra,es ESP,"DF,MF",Dortmund,26,1991,3.9,17,10,10,4,3,8,14,57.1,6,9,2,7,11,28,16,0,Matches,2018
57,Andrea Barzagli,it ITA,DF,Juventus,36,1981,7.3,13,8,12,1,0,7,11,63.6,4,2,1,1,13,26,21,0,Matches,2018
58,Bilal Başaçıkoğlu,tr TUR,FW,Feyenoord,22,1995,0.3,1,1,0,0,1,0,0,,0,1,0,1,0,1,0,0,Matches,2018
59,Michy Batshuayi,be BEL,FW,Chelsea,23,1993,1.4,0,0,0,0,0,0,1,0.0,1,0,0,0,0,0,2,0,Matches,2018
60,Rodrigo Battaglia,ar ARG,MF,Sporting CP,26,1991,6.0,17,14,6,10,1,9,18,50.0,9,8,2,6,9,26,9,0,Matches,2018
61,Sven van Beek,nl NED,DF,Feyenoord,23,1994,3.0,5,2,2,2,1,1,2,50.0,1,4,2,2,4,9,13,0,Matches,2018
62,Wissam Ben Yedder,fr FRA,FW,Sevilla,26,1990,7.2,3,2,0,2,1,2,4,50.0,2,2,0,2,2,5,2,0,Matches,2018
63,Diego Benaglio,ch SUI,GK,Monaco,33,1983,3.0,0,0,0,0,0,0,0,,0,0,0,0,0,0,1,0,Matches,2018
64,Medhi Benatia,ma MAR,DF,Juventus,30,1987,6.3,4,4,2,2,0,1,4,25.0,3,4,0,4,21,25,35,0,Matches,2018
65,Rodrigo Bentancur,uy URU,"MF,FW",Juventus,20,1997,3.2,6,5,1,3,2,3,12,25.0,9,5,1,4,9,15,6,0,Matches,2018
66,Karim Benzema,fr FRA,FW,Real Madrid,29,1987,6.7,5,5,0,4,1,1,5,20.0,4,1,0,1,1,6,8,0,Matches,2018
67,Yuri Berchiche,es ESP,DF,Paris S-G,27,1990,2.0,6,6,4,1,1,3,3,100.0,0,2,2,0,2,8,7,0,Matches,2018
68,Aleksei Berezutski,ru RUS,DF,CSKA Moscow,35,1982,3.0,6,8,5,1,0,5,9,55.6,4,4,0,4,8,14,22,0,Matches,2018
69,Vasili Berezutski,ru RUS,DF,CSKA Moscow,35,1982,5.0,4,2,4,0,0,1,8,12.5,7,4,3,1,5,9,35,1,Matches,2018
70,Steven Berghuis,nl NED,FW,Feyenoord,25,1991,5.2,10,6,3,6,1,1,6,16.7,5,8,0,8,4,14,1,0,Matches,2018
71,Bernard,br BRA,FW,Shakhtar,24,1992,7.6,11,8,7,4,0,5,20,25.0,15,12,0,12,14,25,5,1,Matches,2018
72,Federico Bernardeschi,it ITA,FW,Juventus,23,1994,1.5,4,3,4,0,0,2,4,50.0,2,1,0,1,0,4,2,0,Matches,2018
73,Bernardo,br BRA,DF,RB Leipzig,22,1995,1.3,4,1,2,1,1,2,4,50.0,2,3,0,3,0,4,3,0,Matches,2018
74,Juan Bernat,es ESP,DF,Bayern Munich,24,1993,0.5,1,0,1,0,0,1,1,100.0,0,0,0,0,0,1,2,0,Matches,2018
75,Jean-Claude Billong,cm CMR,DF,NK Maribor,23,1993,4.0,6,4,5,1,0,2,7,28.6,5,5,5,0,6,12,34,0,Matches,2018
76,Nir Bitton,il ISR,"DF,MF",Celtic,25,1991,2.1,11,6,7,3,1,7,9,77.8,2,1,0,1,5,16,7,0,Matches,2018
77,Daley Blind,nl NED,DF,Manchester Utd,27,1990,6.0,13,8,8,3,2,3,11,27.3,8,8,1,7,13,26,23,0,Matches,2018
78,Jérôme Boateng,de GER,DF,Bayern Munich,28,1988,7.5,3,3,2,1,0,2,5,40.0,3,8,4,4,9,12,22,1,Matches,2018
79,Salvatore Bocchetti,it ITA,DF,Spartak Moscow,30,1986,3.0,6,5,4,2,0,2,7,28.6,5,6,4,2,14,20,15,1,Matches,2018
80,Frank Boeckx,be BEL,GK,Anderlecht,30,1986,3.0,0,0,0,0,0,0,0,,0,1,0,1,1,1,0,0,Matches,2018
81,Jean-Paul Boëtius,nl NED,FW,Feyenoord,23,1994,5.8,13,8,4,7,2,0,5,0.0,5,11,0,11,5,18,1,0,Matches,2018
82,Damjan Bohar,si SVN,"MF,FW",NK Maribor,25,1991,5.4,10,6,7,3,0,4,13,30.8,9,1,0,1,6,16,13,2,Matches,2018
83,Gabriel Boschilia,br BRA,DF,Monaco,21,1996,0.1,0,0,0,0,0,0,0,,0,0,0,0,0,0,0,0,Matches,2018
84,Alberto Botía,es ESP,DF,Olympiacos,28,1989,3.0,3,2,3,0,0,3,7,42.9,4,8,7,1,5,8,24,0,Matches,2018
85,Eric Botteghin,br BRA,DF,Feyenoord,29,1987,1.0,0,0,0,0,0,0,2,0.0,2,1,1,0,2,2,7,0,Matches,2018
86,Dedryck Boyata,be BEL,DF,Celtic,26,1990,5.0,6,6,6,0,0,1,4,25.0,3,8,4,4,12,18,37,1,Matches,2018
87,Yacine Brahimi,dz ALG,"FW,MF",Porto,27,1990,6.3,13,9,5,7,1,5,8,62.5,3,9,0,9,5,18,1,0,Matches,2018
88,Claudio Bravo,cl CHI,GK,Manchester City,34,1983,1.0,0,0,0,0,0,0,0,,0,0,0,0,1,1,0,0,Matches,2018
89,Scott Brown,sct SCO,MF,Celtic,32,1985,5.8,13,3,6,7,0,3,15,20.0,12,8,2,6,12,25,9,0,Matches,2018
90,Bruma,pt POR,"FW,MF",RB Leipzig,22,1994,3.0,3,2,0,3,0,2,3,66.7,1,0,0,0,2,5,0,0,Matches,2018
91,Massimo Bruno,be BEL,FW,Anderlecht,23,1993,0.5,1,1,0,1,0,0,0,,0,0,0,0,1,2,0,1,Matches,2018
92,Kevin Bua,ch SUI,"MF,FW",Basel,23,1993,1.1,3,2,0,1,2,0,3,0.0,3,0,0,0,0,3,1,0,Matches,2018
93,Gianluigi Buffon,it ITA,GK,Juventus,39,1978,9.0,0,0,0,0,0,0,3,0.0,3,0,0,0,0,0,2,1,Matches,2018
94,Roman Bürki,ch SUI,GK,Dortmund,26,1990,6.0,0,0,0,0,0,0,1,0.0,1,0,0,0,0,0,3,2,Matches,2018
95,Sergio Busquets,es ESP,MF,Barcelona,29,1988,8.5,23,17,7,14,2,10,28,35.7,18,13,4,9,5,28,8,0,Matches,2018
96,Bohdan Butko,ua UKR,DF,Shakhtar,26,1991,7.0,13,9,11,2,0,6,16,37.5,10,7,2,5,10,23,41,1,Matches,2018
97,Gary Cahill,eng ENG,DF,Chelsea,31,1985,5.0,5,4,5,0,0,1,3,33.3,2,4,2,2,6,11,15,0,Matches,2018
98,Fabrizio Caligara,it ITA,FW,Juventus,17,2000,0.0,0,0,0,0,0,0,0,,0,0,0,0,0,0,0,0,Matches,2018
99,José Callejón,es ESP,FW,Napoli,30,1987,5.6,6,3,2,3,1,2,14,14.3,12,7,1,6,4,10,4,0,Matches,2018
100,Igor de Camargo,be BEL,FW,APOEL FC,34,1983,2.6,3,0,2,1,0,0,1,0.0,1,2,0,2,4,7,5,0,Matches,2018
101,Emre Can,de GER,MF,Liverpool,23,1994,5.9,13,9,5,7,1,1,10,10.0,9,14,1,13,7,20,3,0,Matches,2018
102,Mehdi Carcela,ma MAR,"FW,MF",Olympiacos,28,1989,3.0,10,5,3,7,0,1,4,25.0,3,2,0,2,3,13,0,0,Matches,2018
103,Carlão,br BRA,DF,APOEL FC,31,1986,5.0,7,6,5,2,0,1,2,50.0,1,13,12,1,16,23,19,1,Matches,2018
104,Yannick Carrasco,be BEL,"MF,FW",Atlético Madrid,23,1993,3.0,4,2,0,3,1,2,6,33.3,4,4,1,3,3,7,0,1,Matches,2018
105,Guido Carrillo,ar ARG,FW,Monaco,26,1991,1.5,3,2,0,2,1,1,1,100.0,0,3,2,1,1,4,1,0,Matches,2018
106,Dani Carvajal,es ESP,DF,Real Madrid,25,1992,7.2,23,15,11,7,5,9,14,64.3,5,13,5,8,17,40,14,0,Matches,2018
107,João Carvalho,pt POR,MF,Benfica,20,1997,1.0,0,0,0,0,0,0,1,0.0,1,1,0,1,4,4,0,0,Matches,2018
108,William Carvalho,pt POR,MF,Sporting CP,25,1992,5.0,11,8,3,8,0,3,10,30.0,7,2,1,1,5,16,4,0,Matches,2018
109,Casemiro,br BRA,MF,Real Madrid,25,1992,10.5,45,29,25,14,6,21,45,46.7,24,31,11,20,23,68,25,1,Matches,2018
110,Kiko Casilla,es ESP,GK,Real Madrid,30,1986,2.0,0,0,0,0,0,0,0,,0,0,0,0,0,0,1,0,Matches,2018
111,Iker Casillas,es ESP,GK,Porto,36,1981,3.0,0,0,0,0,0,0,0,,0,0,0,0,0,0,0,0,Matches,2018
112,Gonzalo Castro,de GER,MF,Dortmund,30,1987,1.5,6,3,1,3,2,0,1,0.0,1,0,0,0,2,8,0,0,Matches,2018
113,Edinson Cavani,uy URU,FW,Paris S-G,30,1987,7.6,1,1,0,1,0,0,5,0.0,5,1,1,0,5,6,6,0,Matches,2018
114,Dani Ceballos,es ESP,"MF,FW",Real Madrid,20,1996,0.9,2,1,1,1,0,1,5,20.0,4,2,0,2,2,4,0,0,Matches,2018
115,Franco Cervi,ar ARG,"MF,FW",Benfica,23,1994,1.1,2,2,2,0,0,0,1,0.0,1,3,0,3,0,2,1,0,Matches,2018
116,Bruno César,br BRA,"MF,FW",Sporting CP,28,1988,2.8,2,2,0,1,1,1,3,33.3,2,5,2,3,4,6,0,0,Matches,2018
117,Júlio César,br BRA,GK,Benfica,37,1979,1.0,0,0,0,0,0,0,0,,0,0,0,0,0,0,0,0,Matches,2018
118,Fyodor Chalov,ru RUS,FW,CSKA Moscow,19,1998,1.6,0,0,0,0,0,0,3,0.0,3,0,0,0,1,1,2,0,Matches,2018
119,Giorgio Chiellini,it ITA,DF,Juventus,32,1984,7.0,15,10,8,5,2,3,8,37.5,5,8,3,5,13,28,46,0,Matches,2018
120,Alexandru Chipciu,ro ROU,DF,Anderlecht,28,1989,2.0,8,6,7,0,1,5,9,55.6,4,1,0,1,6,14,2,0,Matches,2018
121,Vlad Chiricheș,ro ROU,DF,Napoli,27,1989,1.0,1,1,1,0,0,1,2,50.0,1,1,0,1,1,2,1,0,Matches,2018
122,Andreas Christensen,dk DEN,DF,Chelsea,21,1996,5.0,5,3,4,1,0,3,6,50.0,3,4,1,3,8,13,22,1,Matches,2018
123,Jasper Cillessen,nl NED,GK,Barcelona,28,1989,1.0,0,0,0,0,0,0,0,,0,0,0,0,0,0,1,0,Matches,2018
124,Orkan Çınar,tr TUR,FW,Beşiktaş,21,1996,0.2,1,1,1,0,0,1,2,50.0,1,0,0,0,0,1,0,0,Matches,2018
125,Nathaniel Clyne,eng ENG,DF,Liverpool,26,1991,0.1,1,1,1,0,0,0,0,,0,0,0,0,0,1,1,0,Matches,2018
126,Sebastián Coates,uy URU,DF,Sporting CP,26,1990,5.0,12,9,10,2,0,6,12,50.0,6,10,7,3,14,26,19,0,Matches,2018
127,Fábio Coentrão,pt POR,"DF,MF",Sporting CP,29,1988,3.0,4,2,1,2,1,3,6,50.0,3,3,1,2,6,10,11,0,Matches,2018
128,Kingsley Coman,fr FRA,"FW,MF",Bayern Munich,21,1996,4.3,6,4,1,4,1,0,2,0.0,2,4,0,4,1,7,0,0,Matches,2018
129,Marvin Compper,de GER,DF,RB Leipzig,32,1985,0.2,0,0,0,0,0,0,0,,0,0,0,0,1,1,0,0,Matches,2018
130,Sébastien Corchia,fr FRA,DF,Sevilla,26,1990,1.2,2,2,0,1,1,2,3,66.7,1,0,0,0,2,4,2,0,Matches,2018
131,Jesús Corona,mx MEX,MF,Porto,24,1993,3.5,12,9,7,5,0,4,14,28.6,10,5,0,5,7,19,0,0,Matches,2018
132,Ángel Correa,ar ARG,"MF,FW",Atlético Madrid,22,1995,2.8,2,0,1,0,1,0,6,0.0,6,3,0,3,3,5,2,0,Matches,2018
133,Joaquín Correa,ar ARG,FW,Sevilla,22,1994,7.0,13,7,2,8,3,2,13,15.4,11,4,0,4,7,20,3,0,Matches,2018
134,Douglas Costa,br BRA,"FW,MF",Juventus,26,1990,8.0,6,1,3,3,0,1,14,7.1,13,7,0,7,8,14,3,0,Matches,2018
135,Thibaut Courtois,be BEL,GK,Chelsea,25,1992,8.0,0,0,0,0,0,0,0,,0,0,0,0,2,2,0,1,Matches,2018
136,Philippe Coutinho,br BRA,"MF,FW",Liverpool,25,1992,3.9,3,0,1,2,0,1,3,33.3,2,3,1,2,4,7,2,0,Matches,2018
137,Juan Cuadrado,co COL,FW,Juventus,29,1988,4.6,17,10,7,7,3,6,13,46.2,7,2,0,2,5,22,5,1,Matches,2018
138,Mahmoud Dahoud,de GER,MF,Dortmund,21,1996,2.1,5,2,3,1,1,1,2,50.0,1,3,0,3,2,7,3,1,Matches,2018
139,Diogo Dalot,pt POR,DF,Porto,18,1999,1.0,1,0,1,0,0,0,1,0.0,1,1,0,1,2,3,7,0,Matches,2018
140,Danilo,br BRA,DF,Manchester City,26,1991,4.1,12,9,5,6,1,7,10,70.0,3,7,1,6,7,19,13,0,Matches,2018
141,Matteo Darmian,it ITA,DF,Manchester Utd,27,1989,2.3,8,5,5,3,0,2,2,100.0,0,2,1,1,5,13,5,0,Matches,2018
142,Ben Davies,wls WAL,DF,Tottenham,24,1993,5.0,8,6,4,3,1,4,10,40.0,6,8,1,7,6,14,23,0,Matches,2018
143,Kevin De Bruyne,be BEL,MF,Manchester City,26,1991,7.4,13,9,2,9,2,7,22,31.8,15,6,2,4,12,25,2,0,Matches,2018
144,Daniele De Rossi,it ITA,MF,Roma,34,1983,8.6,14,10,8,6,0,7,22,31.8,15,13,3,10,14,28,13,0,Matches,2018
145,Mattia De Sciglio,it ITA,DF,Juventus,24,1992,4.4,7,3,5,2,0,6,7,85.7,1,4,2,2,1,8,18,1,Matches,2018
146,Grégoire Defrel,mq MTQ,FW,Roma,26,1991,1.8,3,2,1,1,1,0,0,,0,1,0,1,1,4,1,1,Matches,2018
147,Fabian Delph,eng ENG,DF,Manchester City,27,1989,4.3,10,8,3,7,0,6,14,42.9,8,3,0,3,8,18,15,0,Matches,2018
148,Mousa Dembélé,be BEL,MF,Tottenham,30,1987,3.6,10,6,1,6,3,2,5,40.0,3,4,1,3,6,16,1,0,Matches,2018
149,Moussa Dembélé,fr FRA,FW,Celtic,21,1996,3.0,3,3,0,3,0,0,0,,0,1,0,1,1,4,2,0,Matches,2018
150,Ousmane Dembélé,fr FRA,"MF,FW",Barcelona,20,1997,1.6,1,1,0,1,0,0,6,0.0,6,1,0,1,2,3,1,0,Matches,2018
151,Diego Demme,de GER,MF,RB Leipzig,25,1991,3.6,10,8,3,6,1,4,14,28.6,10,3,0,3,6,16,7,0,Matches,2018
152,Leander Dendoncker,be BEL,"MF,DF",Anderlecht,22,1995,6.0,9,2,4,5,0,5,14,35.7,9,4,1,3,15,24,4,2,Matches,2018
153,Dentinho,br BRA,"MF,FW",Shakhtar,28,1989,0.4,1,0,0,0,1,1,1,100.0,0,0,0,0,0,1,0,0,Matches,2018
154,Jan-Arie van der Heijden,nl NED,DF,Feyenoord,29,1988,1.0,0,0,0,0,0,0,0,,0,2,2,0,0,0,4,0,Matches,2018
155,Olivier Deschacht,be BEL,DF,Anderlecht,36,1981,3.6,3,3,2,1,0,2,3,66.7,1,4,2,2,3,6,11,1,Matches,2018
156,Gerard Deulofeu,es ESP,"FW,MF",Barcelona,23,1994,1.6,0,0,0,0,0,0,5,0.0,5,0,0,0,2,2,0,0,Matches,2018
157,Ángel Di María,ar ARG,FW,Paris S-G,29,1988,1.6,1,1,1,0,0,1,2,50.0,1,1,0,1,0,1,0,0,Matches,2018
158,Adama Diakhaby,fr FRA,FW,Monaco,21,1996,2.5,7,4,4,3,0,3,5,60.0,2,4,0,4,2,9,2,0,Matches,2018
159,Lassana Diarra,fr FRA,MF,Paris S-G,32,1985,0.1,0,0,0,0,0,0,0,,0,0,0,0,1,1,0,0,Matches,2018
160,Rúben Dias,pt POR,DF,Benfica,20,1997,2.0,4,3,3,1,0,1,2,50.0,1,2,2,0,1,5,13,0,Matches,2018
161,Amadou Diawara,gn GUI,MF,Napoli,20,1997,4.1,5,2,2,2,1,1,6,16.7,5,7,1,6,7,12,3,0,Matches,2018
162,Brahim Díaz,es ESP,"MF,FW",Manchester City,17,1999,0.6,0,0,0,0,0,0,0,,0,0,0,0,0,0,0,0,Matches,2018
163,Serey Die,ci CIV,MF,Basel,32,1984,3.2,10,5,3,5,2,7,18,38.9,11,6,1,5,7,17,0,0,Matches,2018
164,Eric Dier,eng ENG,"MF,DF",Tottenham,23,1994,6.8,14,9,6,6,2,5,10,50.0,5,8,4,4,5,19,23,1,Matches,2018
165,Lucas Digne,fr FRA,DF,Barcelona,24,1993,3.0,8,4,3,2,3,2,3,66.7,1,3,0,3,6,14,7,0,Matches,2018
166,Kevin Diks,nl NED,DF,Feyenoord,20,1996,2.0,6,4,5,1,0,4,5,80.0,1,2,0,2,5,11,4,1,Matches,2018
167,Joshgun Diniyev,az AZE,MF,Qarabağ FK,21,1995,0.7,0,0,0,0,0,0,2,0.0,2,0,0,0,0,0,0,0,Matches,2018
168,Bas Dost,nl NED,FW,Sporting CP,28,1989,4.2,3,0,3,0,0,0,0,,0,1,0,1,1,4,3,0,Matches,2018
169,Douglas,br BRA,DF,Benfica,26,1990,3.0,10,6,8,1,1,7,13,53.8,6,0,0,0,5,15,2,1,Matches,2018
170,Seydou Doumbia,ci CIV,FW,Sporting CP,29,1987,1.3,0,0,0,0,0,0,1,0.0,1,0,0,0,0,0,0,0,Matches,2018
171,Julian Draxler,de GER,MF,Paris S-G,23,1993,3.5,6,4,2,2,2,1,7,14.3,6,2,1,1,6,12,2,0,Matches,2018
172,Danny Drinkwater,eng ENG,MF,Chelsea,27,1990,0.4,1,0,0,1,0,0,1,0.0,1,1,0,1,0,1,1,0,Matches,2018
173,Paulo Dybala,ar ARG,"MF,FW",Juventus,23,1993,7.3,4,3,0,4,0,1,9,11.1,8,7,0,7,0,4,1,0,Matches,2018
174,Alan Dzagoev,ru RUS,"MF,FW",CSKA Moscow,27,1990,4.1,3,0,2,0,1,1,12,8.3,11,7,0,7,1,4,5,0,Matches,2018
175,Edin Džeko,ba BIH,FW,Roma,31,1986,12.0,6,5,0,3,3,0,4,0.0,4,2,0,2,0,6,9,1,Matches,2018
176,Georgi Dzhikiya,ru RUS,DF,Spartak Moscow,23,1993,4.7,8,6,4,3,1,5,5,100.0,0,2,2,0,10,18,30,0,Matches,2018
177,Lorenzo Ebecilio,nl NED,"MF,FW",APOEL FC,25,1991,2.9,5,2,4,0,1,1,3,33.3,2,2,0,2,2,7,3,0,Matches,2018
178,Ederson,br BRA,GK,Manchester City,23,1993,9.0,0,0,0,0,0,0,3,0.0,3,0,0,0,1,1,5,0,Matches,2018
179,Odsonne Édouard,fr FRA,FW,Celtic,19,1998,0.4,0,0,0,0,0,0,2,0.0,2,1,0,1,0,0,1,0,Matches,2018
180,Giorgos Efrem,cy CYP,MF,APOEL FC,28,1989,0.3,0,0,0,0,0,0,0,,0,2,0,2,0,0,0,0,Matches,2018
181,Omar Elabdellaoui,no NOR,DF,Olympiacos,25,1991,4.0,3,3,3,0,0,2,3,66.7,1,3,0,3,12,15,13,0,Matches,2018
182,Eliseu,pt POR,DF,Benfica,33,1983,2.2,1,1,1,0,0,0,1,0.0,1,2,0,2,4,5,3,0,Matches,2018
183,Mohamed Elyounoussi,no NOR,"FW,MF",Basel,22,1994,7.1,3,2,2,1,0,0,15,0.0,15,14,5,9,7,10,6,0,Matches,2018
184,Tarik Elyounoussi,no NOR,"FW,MF",Qarabağ FK,29,1988,0.4,1,1,1,0,0,1,1,100.0,0,1,0,1,2,3,0,0,Matches,2018
185,Emmanuel Emenike,ng NGA,FW,Olympiacos,30,1987,1.3,0,0,0,0,0,0,0,,0,0,0,0,0,0,1,0,Matches,2018
186,Björn Engels,be BEL,DF,Olympiacos,22,1994,5.0,4,2,2,2,0,2,5,40.0,3,7,6,1,4,8,30,1,Matches,2018
187,Christian Eriksen,dk DEN,"MF,FW",Tottenham,25,1992,5.9,5,3,0,3,2,1,7,14.3,6,7,2,5,4,9,2,0,Matches,2018
188,Caner Erkin,tr TUR,DF,Beşiktaş,28,1988,5.8,7,2,4,3,0,4,19,21.1,15,2,0,2,21,28,14,0,Matches,2018
189,Sergio Escudero,es ESP,DF,Sevilla,27,1989,10.0,21,12,11,7,3,9,19,47.4,10,6,2,4,19,40,39,0,Matches,2018
190,Fabinho,br BRA,MF,Monaco,23,1993,5.0,18,7,8,7,3,7,11,63.6,4,6,0,6,8,26,5,0,Matches,2018
191,Cesc Fàbregas,es ESP,MF,Chelsea,30,1987,7.7,19,12,10,3,6,6,22,27.3,16,11,1,10,14,33,4,0,Matches,2018
192,Fabricio,es ESP,GK,Beşiktaş,29,1987,6.0,0,0,0,0,0,0,0,,0,0,0,0,0,0,6,0,Matches,2018
193,Radamel Falcao,co COL,FW,Monaco,31,1986,4.3,5,4,3,1,1,1,1,100.0,0,3,2,1,2,7,4,0,Matches,2018
194,Agustín Farías,ar ARG,"MF,FW",APOEL FC,29,1987,0.9,7,4,5,0,2,3,8,37.5,5,2,1,1,2,9,3,0,Matches,2018
195,Federico Fazio,ar ARG,DF,Roma,30,1987,10.2,21,11,13,8,0,10,18,55.6,8,17,12,5,21,42,45,1,Matches,2018
196,Ljubomir Fejsa,rs SRB,MF,Benfica,28,1988,4.0,7,5,1,6,0,2,6,33.3,4,4,1,3,6,13,6,0,Matches,2018
197,Felipe,br BRA,DF,Porto,28,1989,6.4,11,6,10,1,0,3,10,30.0,7,12,8,4,22,33,39,0,Matches,2018
198,Marouane Fellaini,be BEL,MF,Manchester Utd,29,1987,2.5,3,3,0,3,0,0,3,0.0,3,0,0,0,2,5,6,0,Matches,2018
199,Bruno Fernandes,pt POR,MF,Sporting CP,22,1994,6.0,15,7,6,7,2,5,16,31.3,11,6,1,5,4,19,1,1,Matches,2018
200,Mário Fernandes,ru RUS,"FW,MF",CSKA Moscow,26,1990,6.0,14,10,3,9,2,5,11,45.5,6,3,1,2,7,21,27,0,Matches,2018
201,Augusto Fernández,ar ARG,MF,Atlético Madrid,31,1986,0.6,0,0,0,0,0,0,2,0.0,2,1,1,0,2,2,0,0,Matches,2018
202,Fernandinho,br BRA,"MF,DF",Manchester City,32,1985,7.6,17,10,8,8,1,10,30,33.3,20,9,1,8,14,31,19,1,Matches,2018
203,Fernando,br BRA,MF,Spartak Moscow,25,1992,6.0,7,5,3,3,1,2,15,13.3,13,7,0,7,12,19,9,1,Matches,2018
204,Facundo Ferreyra,ar ARG,FW,Shakhtar,26,1991,7.8,6,2,1,4,1,0,1,0.0,1,8,1,7,1,7,4,0,Matches,2018
205,Diogo Figueiras,pt POR,"DF,MF",Olympiacos,26,1991,4.0,7,3,4,3,0,2,4,50.0,2,2,1,1,13,20,14,0,Matches,2018
206,Tobias Figueiredo,pt POR,DF,Sporting CP,23,1994,0.1,0,0,0,0,0,0,0,,0,0,0,0,0,0,1,0,Matches,2018
207,Roberto Firmino,br BRA,FW,Liverpool,25,1991,11.7,23,17,3,15,5,0,20,0.0,20,11,1,10,3,26,5,0,Matches,2018
208,Alessandro Florenzi,it ITA,"DF,FW",Roma,26,1991,7.9,12,9,10,1,1,8,23,34.8,15,8,0,8,17,29,10,0,Matches,2018
209,Phil Foden,eng ENG,"MF,DF",Manchester City,17,2000,2.2,2,1,0,2,0,1,7,14.3,6,0,0,0,0,2,1,0,Matches,2018
210,James Forrest,sct SCO,"DF,FW",Celtic,26,1991,3.4,4,1,1,3,0,2,6,33.3,4,1,0,1,2,6,4,0,Matches,2018
211,Emil Forsberg,se SWE,"MF,FW",RB Leipzig,25,1991,4.6,5,4,0,4,1,0,4,0.0,4,5,0,5,1,6,2,0,Matches,2018
212,Hernâni Fortes,pt POR,MF,Porto,25,1991,0.2,0,0,0,0,0,0,2,0.0,2,0,0,0,0,0,0,0,Matches,2018
213,Kostas Fortounis,gr GRE,"FW,MF",Olympiacos,24,1992,2.7,2,2,0,2,0,0,1,0.0,1,0,0,0,0,2,0,0,Matches,2018
214,Juan Foyth,ar ARG,DF,Tottenham,19,1998,1.0,2,0,2,0,0,0,0,,0,2,1,1,1,3,2,0,Matches,2018
215,Alexander Fransson,se SWE,MF,Basel,23,1994,0.1,0,0,0,0,0,0,0,,0,0,0,0,0,0,0,0,Matches,2018
216,Fred,br BRA,MF,Shakhtar,24,1993,8.0,23,16,11,10,2,8,26,30.8,18,15,3,12,9,32,6,1,Matches,2018
217,Fabian Frei,ch SUI,"DF,MF",Basel,28,1989,2.0,1,1,0,1,0,0,2,0.0,2,1,0,1,8,9,8,0,Matches,2018
218,Marco Friedl,at AUT,DF,Bayern Munich,19,1998,1.0,1,1,1,0,0,1,2,50.0,1,2,0,2,3,4,4,0,Matches,2018
219,Gabi,es ESP,MF,Atlético Madrid,34,1983,3.9,7,2,2,3,2,4,13,30.8,9,5,1,4,2,9,4,0,Matches,2018
220,Nicolás Gaitán,ar ARG,MF,Atlético Madrid,29,1988,1.4,5,2,3,1,1,2,5,40.0,3,1,0,1,5,10,0,0,Matches,2018
221,Cristian Gamboa,cr CRC,DF,Celtic,27,1989,1.0,3,2,3,0,0,3,5,60.0,2,2,1,1,3,6,3,0,Matches,2018
222,Kévin Gameiro,fr FRA,FW,Atlético Madrid,30,1987,1.8,0,0,0,0,0,0,3,0.0,3,2,1,1,2,2,0,0,Matches,2018
223,Ganso,br BRA,MF,Sevilla,27,1989,0.3,1,1,0,1,0,0,2,0.0,2,1,0,1,0,1,0,0,Matches,2018
224,Gara Garayev,az AZE,MF,Qarabağ FK,24,1992,5.8,10,8,7,3,0,4,14,28.6,10,7,2,5,8,18,9,0,Matches,2018
225,David de Gea,es ESP,GK,Manchester Utd,26,1990,6.0,0,0,0,0,0,0,0,,0,0,0,0,0,0,0,0,Matches,2018
226,Johannes Geis,de GER,DF,Sevilla,23,1993,1.0,1,1,1,0,0,1,2,50.0,1,1,1,0,0,1,3,0,Matches,2018
227,Anthony Georgiou,cy CYP,MF,Tottenham,20,1997,0.1,0,0,0,0,0,0,0,,0,1,0,1,0,0,0,0,Matches,2018
228,Pieter Gerkens,be BEL,"FW,MF",Anderlecht,21,1995,4.5,8,5,0,7,1,2,10,20.0,8,4,0,4,3,11,0,0,Matches,2018
229,Gerson,br BRA,FW,Roma,20,1997,2.4,9,5,3,3,3,3,5,60.0,2,5,1,4,2,11,1,0,Matches,2018
230,Rachid Ghezzal,dz ALG,"MF,FW",Monaco,25,1992,1.6,3,0,2,0,1,1,3,33.3,2,1,0,1,3,6,0,0,Matches,2018
231,Faouzi Ghoulam,dz ALG,DF,Napoli,26,1991,3.3,5,4,2,2,1,3,7,42.9,4,3,1,2,5,10,3,0,Matches,2018
232,Guillaume Gillet,be BEL,MF,Olympiacos,33,1984,2.8,8,4,2,6,0,1,4,25.0,3,3,0,3,5,13,3,0,Matches,2018
233,Olivier Giroud,fr FRA,FW,Chelsea,30,1986,0.7,0,0,0,0,0,0,1,0.0,1,0,0,0,0,0,1,0,Matches,2018
234,Kamil Glik,pl POL,DF,Monaco,29,1988,6.0,10,9,8,2,0,5,8,62.5,3,4,1,3,4,14,31,0,Matches,2018
235,Denis Glushakov,ru RUS,MF,Spartak Moscow,30,1987,3.7,6,2,3,3,0,3,11,27.3,8,5,1,4,4,10,4,0,Matches,2018
236,Diego Godín,uy URU,DF,Atlético Madrid,31,1986,4.0,9,7,6,3,0,5,11,45.5,6,1,0,1,8,17,11,0,Matches,2018
237,Aleksandr Golovin,ru RUS,MF,CSKA Moscow,21,1996,6.0,13,9,5,6,2,5,23,21.7,18,5,1,4,10,23,2,0,Matches,2018
238,André Gomes,pt POR,MF,Barcelona,24,1993,1.9,8,7,1,6,1,3,6,50.0,3,0,0,0,2,10,2,0,Matches,2018
239,Joe Gomez,eng ENG,DF,Liverpool,20,1997,4.1,10,7,6,4,0,2,8,25.0,6,10,1,9,12,22,14,0,Matches,2018
240,Maxime Gonalons,fr FRA,MF,Roma,28,1989,3.4,9,6,5,3,1,1,8,12.5,7,4,0,4,7,16,3,2,Matches,2018
241,Diogo Gonçalves,pt POR,"FW,MF",Benfica,20,1997,3.0,0,0,0,0,0,0,2,0.0,2,2,0,2,0,0,0,0,Matches,2018
242,Gökhan Gönül,tr TUR,DF,Beşiktaş,32,1985,3.2,13,10,8,4,1,6,10,60.0,4,2,0,2,14,27,11,0,Matches,2018
243,Craig Gordon,sct SCO,GK,Celtic,34,1982,6.0,0,0,0,0,0,0,1,0.0,1,0,0,0,1,1,1,1,Matches,2018
244,Astemir Gordyushenko,ru RUS,FW,CSKA Moscow,20,1997,0.3,4,2,2,1,1,0,3,0.0,3,1,0,1,0,4,1,0,Matches,2018
245,Mario Götze,de GER,MF,Dortmund,25,1992,4.1,9,6,4,4,1,2,13,15.4,11,5,0,5,2,11,1,0,Matches,2018
246,Antoine Griezmann,fr FRA,FW,Atlético Madrid,26,1991,5.9,6,4,1,5,0,1,1,100.0,0,4,0,4,2,8,2,0,Matches,2018
247,Leigh Griffiths,sct SCO,FW,Celtic,26,1990,2.8,3,2,0,3,0,0,4,0.0,4,5,0,5,2,5,1,0,Matches,2018
248,Álex Grimaldo,es ESP,DF,Benfica,21,1995,3.6,7,3,4,2,1,6,13,46.2,7,5,0,5,5,12,3,0,Matches,2018
249,Marko Grujić,rs SRB,FW,Liverpool,21,1996,0.1,0,0,0,0,0,0,0,,0,0,0,0,0,0,0,0,Matches,2018
250,Raúl Gudiño,mx MEX,GK,APOEL FC,21,1996,0.5,0,0,0,0,0,0,0,,0,0,0,0,0,0,0,0,Matches,2018
251,Raphaël Guerreiro,pt POR,"MF,DF",Dortmund,23,1993,2.8,1,0,1,0,0,0,2,0.0,2,3,0,3,4,5,2,0,Matches,2018
252,Wilde-Donald Guerrier,ht HAI,"DF,MF",Qarabağ FK,28,1989,3.9,8,7,6,1,1,3,6,50.0,3,2,0,2,4,12,9,0,Matches,2018
253,Péter Gulácsi,hu HUN,GK,RB Leipzig,27,1990,6.0,0,0,0,0,0,0,0,,0,0,0,0,0,0,2,1,Matches,2018
254,İlkay Gündoğan,de GER,MF,Manchester City,26,1990,5.6,16,11,5,9,2,3,12,25.0,9,0,0,0,8,24,2,0,Matches,2018
255,Achraf Hakimi,ma MAR,DF,Real Madrid,18,1998,2.0,3,3,0,2,1,2,3,66.7,1,3,0,3,1,4,3,0,Matches,2018
256,Marcel Halstenberg,de GER,DF,RB Leipzig,25,1991,5.2,16,15,9,6,1,6,14,42.9,8,3,1,2,9,25,11,0,Matches,2018
257,Marek Hamšík,sk SVK,MF,Napoli,30,1987,5.2,8,5,0,7,1,1,11,9.1,10,4,0,4,5,13,5,2,Matches,2018
258,Jasmin Handanović,si SVN,GK,NK Maribor,39,1978,6.0,0,0,0,0,0,0,0,,0,0,0,0,0,0,7,2,Matches,2018
259,Sofiane Hanni,dz ALG,"FW,MF",Anderlecht,26,1990,5.2,3,3,0,2,1,0,3,0.0,3,9,0,9,10,13,4,0,Matches,2018
260,Ridgeciano Haps,sr SUR,DF,Feyenoord,24,1993,4.0,10,8,7,3,0,3,5,60.0,2,4,1,3,13,23,11,0,Matches,2018
261,Hamdi Harbaoui,tn TUN,FW,Anderlecht,32,1985,0.2,0,0,0,0,0,0,0,,0,0,0,0,1,1,0,0,Matches,2018
262,Eden Hazard,be BEL,"FW,MF",Chelsea,26,1991,6.8,2,2,0,1,1,0,2,0.0,2,3,0,3,1,3,2,0,Matches,2018
263,Jordan Henderson,eng ENG,MF,Liverpool,27,1990,9.6,24,14,6,16,2,7,23,30.4,16,17,5,12,16,40,12,0,Matches,2018
264,Pedro Henrique,br BRA,"FW,MF",Qarabağ FK,27,1990,3.1,6,5,1,4,1,1,8,12.5,7,2,0,2,1,7,5,0,Matches,2018
265,Lucas Hernández,fr FRA,DF,Atlético Madrid,21,1996,3.0,1,1,1,0,0,0,1,0.0,1,5,1,4,7,8,8,0,Matches,2018
266,Theo Hernández,fr FRA,DF,Real Madrid,19,1997,1.5,3,2,1,1,1,3,6,50.0,3,0,0,0,1,4,1,0,Matches,2018
267,Ander Herrera,es ESP,MF,Manchester Utd,27,1989,4.2,13,10,6,7,0,1,12,8.3,11,8,1,7,12,25,7,0,Matches,2018
268,Héctor Herrera,mx MEX,MF,Porto,27,1990,5.9,19,15,5,13,1,3,19,15.8,16,9,1,8,8,27,2,0,Matches,2018
269,Son Heung-min,kr KOR,"FW,MF",Tottenham,25,1992,4.7,7,5,3,3,1,2,11,18.2,9,4,0,4,0,7,2,0,Matches,2018
270,Gonzalo Higuaín,ar ARG,FW,Juventus,29,1987,9.2,10,4,0,6,4,1,6,16.7,5,5,0,5,4,14,7,1,Matches,2018
271,Dino Hotić,ba BIH,"MF,FW",NK Maribor,22,1995,1.7,1,0,0,1,0,0,2,0.0,2,2,0,2,1,2,1,0,Matches,2018
272,Mats Hummels,de GER,DF,Bayern Munich,28,1988,7.5,18,12,14,4,0,6,13,46.2,7,7,2,5,10,28,27,0,Matches,2018
273,Badavi Huseynov,az AZE,DF,Qarabağ FK,26,1991,3.0,5,5,4,1,0,3,5,60.0,2,4,2,2,8,13,13,0,Matches,2018
274,Atiba Hutchinson,ca CAN,MF,Beşiktaş,34,1983,6.3,19,11,10,7,2,7,16,43.8,9,7,4,3,12,31,9,0,Matches,2018
275,Elseid Hysaj,al ALB,DF,Napoli,23,1994,5.8,14,10,9,4,1,5,12,41.7,7,3,1,2,14,28,15,0,Matches,2018
276,Zlatan Ibrahimović,se SWE,FW,Manchester Utd,35,1981,0.2,0,0,0,0,0,0,0,,0,0,0,0,0,0,0,0,Matches,2018
277,Sergei Ignashevich,ru RUS,DF,CSKA Moscow,38,1979,3.5,5,2,1,4,0,2,5,40.0,3,5,3,2,11,16,15,0,Matches,2018
278,Stefan Ilsanker,at AUT,"DF,MF",RB Leipzig,28,1989,2.9,12,7,3,8,1,6,7,85.7,1,1,1,0,6,18,16,0,Matches,2018
279,Danny Ings,eng ENG,FW,Liverpool,25,1992,0.6,3,2,0,2,1,1,1,100.0,0,3,0,3,1,4,0,0,Matches,2018
280,Andrés Iniesta,es ESP,MF,Barcelona,33,1984,6.9,11,8,4,5,2,3,12,25.0,9,12,1,11,8,19,4,0,Matches,2018
281,Lorenzo Insigne,it ITA,FW,Napoli,26,1991,4.3,1,1,0,1,0,0,7,0.0,7,3,0,3,7,8,0,0,Matches,2018
282,Alexander Isak,se SWE,FW,Dortmund,17,1999,0.1,0,0,0,0,0,0,0,,0,0,0,0,0,0,0,0,Matches,2018
283,Isco,es ESP,MF,Real Madrid,25,1992,8.2,14,11,5,4,5,4,21,19.0,17,6,1,5,2,16,1,0,Matches,2018
284,Ismaily,br BRA,DF,Shakhtar,27,1990,7.7,14,11,8,5,1,4,8,50.0,4,8,2,6,15,29,17,0,Matches,2018
285,Afran Ismayilov,az AZE,MF,Qarabağ FK,28,1988,0.8,6,5,4,2,0,3,4,75.0,1,0,0,0,1,7,0,0,Matches,2018
286,Cedric Itten,ch SUI,MF,Basel,20,1996,0.1,0,0,0,0,0,0,0,,0,0,0,0,0,0,0,0,Matches,2018
287,Jardel,br BRA,DF,Benfica,31,1986,4.0,6,2,2,4,0,0,3,0.0,3,4,3,1,10,16,10,0,Matches,2018
288,Jemerson,br BRA,DF,Monaco,24,1992,6.0,6,5,5,1,0,0,6,0.0,6,7,3,4,13,19,31,2,Matches,2018
289,Gabriel Jesus,br BRA,FW,Manchester City,20,1997,6.9,9,6,4,4,1,0,8,0.0,8,9,0,9,7,16,3,0,Matches,2018
290,Juan Jesus,br BRA,DF,Roma,26,1991,5.7,15,8,9,6,0,7,14,50.0,7,13,11,2,4,19,31,0,Matches,2018
291,Raúl Jiménez,mx MEX,FW,Benfica,26,1991,3.4,2,1,0,2,0,1,1,100.0,0,10,0,10,5,7,1,0,Matches,2018
292,Jonas,br BRA,"FW,MF",Benfica,33,1984,3.2,3,2,0,3,0,1,4,25.0,3,3,0,3,0,3,2,0,Matches,2018
293,Brad Jones,au AUS,GK,Feyenoord,35,1982,5.0,0,0,0,0,0,0,1,0.0,1,0,0,0,1,1,4,0,Matches,2018
294,Jorge,br BRA,DF,Monaco,21,1996,4.0,14,9,4,10,0,6,9,66.7,3,4,0,4,9,23,11,0,Matches,2018
295,Jorginho,it ITA,MF,Napoli,25,1991,1.8,7,3,3,3,1,2,8,25.0,6,6,2,4,3,10,0,0,Matches,2018
296,Stevan Jovetić,me MNE,FW,Monaco,27,1989,0.7,0,0,0,0,0,0,0,,0,0,0,0,0,0,1,0,Matches,2018
297,Juanfran,es ESP,DF,Atlético Madrid,32,1985,3.0,10,8,5,4,1,4,5,80.0,1,1,0,1,5,15,4,0,Matches,2018
298,Nicolai Jørgensen,dk DEN,FW,Feyenoord,26,1991,2.9,2,2,0,1,1,0,0,,0,1,1,0,0,2,2,0,Matches,2018
299,Marwan Kabha,il ISR,MF,NK Maribor,26,1991,5.8,20,13,12,8,0,4,19,21.1,15,7,3,4,6,26,8,0,Matches,2018
300,Shinji Kagawa,jp JPN,"MF,FW",Dortmund,28,1989,4.5,3,2,0,1,2,0,3,0.0,3,3,0,3,3,6,1,0,Matches,2018
301,Dominik Kaiser,de GER,MF,RB Leipzig,28,1988,0.2,0,0,0,0,0,0,0,,0,0,0,0,0,0,1,0,Matches,2018
302,Kevin Kampl,si SVN,MF,RB Leipzig,26,1990,4.6,6,4,0,5,1,3,7,42.9,4,5,0,5,9,15,8,0,Matches,2018
303,Harry Kane,eng ENG,FW,Tottenham,24,1993,6.6,2,2,0,2,0,1,5,20.0,4,4,2,2,2,4,8,0,Matches,2018
304,N'Golo Kanté,fr FRA,MF,Chelsea,26,1991,5.5,22,18,10,10,2,4,13,30.8,9,8,1,7,15,37,3,0,Matches,2018
305,Stefanos Kapino,gr GRE,GK,Olympiacos,23,1994,1.0,0,0,0,0,0,0,0,,0,0,0,0,0,0,0,1,Matches,2018
306,Loris Karius,de GER,GK,Liverpool,24,1993,13.0,0,0,0,0,0,0,0,,0,0,0,0,0,0,7,3,Matches,2018
307,Naby Keïta,gn GUI,MF,RB Leipzig,22,1995,4.7,15,10,4,9,2,3,11,27.3,8,8,1,7,12,27,6,0,Matches,2018
308,Sami Khedira,de GER,MF,Juventus,30,1987,7.0,11,7,6,4,1,6,16,37.5,10,6,2,4,4,15,11,0,Matches,2018
309,Davit Khocholava,ge GEO,DF,Shakhtar,24,1993,1.2,0,0,0,0,0,0,0,,0,1,1,0,1,1,6,0,Matches,2018
310,Khetag Khosonov,ru RUS,MF,CSKA Moscow,19,1998,0.0,0,0,0,0,0,0,0,,0,0,0,0,0,0,0,0,Matches,2018
311,Joshua Kimmich,de GER,DF,Bayern Munich,22,1995,10.0,12,10,5,3,4,6,15,40.0,9,6,1,5,11,23,14,0,Matches,2018
312,Presnel Kimpembe,fr FRA,DF,Paris S-G,21,1995,2.2,2,1,2,0,0,0,0,,0,1,0,1,1,3,7,0,Matches,2018
313,Simon Kjær,dk DEN,DF,Sevilla,28,1989,6.0,12,6,7,5,0,6,9,66.7,3,11,8,3,12,24,33,0,Matches,2018
314,Ragnar Klavan,ee EST,DF,Liverpool,31,1985,3.3,1,1,0,1,0,0,1,0.0,1,6,6,0,4,5,18,0,Matches,2018
315,Lukas Klostermann,de GER,DF,RB Leipzig,21,1996,5.1,9,7,6,3,0,3,11,27.3,8,2,1,1,7,16,11,0,Matches,2018
316,Koke,es ESP,MF,Atlético Madrid,25,1992,3.7,6,4,5,0,1,2,9,22.2,7,6,0,6,2,8,0,0,Matches,2018
317,Aleksandar Kolarov,rs SRB,DF,Roma,31,1985,12.0,22,14,9,10,3,9,17,52.9,8,10,2,8,18,40,23,1,Matches,2018
318,Dmitri Kombarov,ru RUS,DF,Spartak Moscow,30,1987,4.0,9,4,2,5,2,5,9,55.6,4,6,3,3,8,17,7,0,Matches,2018
319,Vincent Kompany,be BEL,DF,Manchester City,31,1986,2.0,2,1,2,0,0,2,5,40.0,3,2,2,0,3,5,4,0,Matches,2018
320,Terence Kongolo,nl NED,DF,Monaco,23,1994,1.0,4,3,3,1,0,3,4,75.0,1,4,3,1,1,5,7,0,Matches,2018
321,Eboue Kouassi,ci CIV,MF,Celtic,19,1997,0.2,0,0,0,0,0,0,0,,0,1,0,1,0,0,0,0,Matches,2018
322,Kalidou Koulibaly,sn SEN,DF,Napoli,26,1991,5.0,10,7,8,2,0,3,6,50.0,3,9,7,2,9,19,19,0,Matches,2018
323,Leonardo Koutris,gr GRE,DF,Olympiacos,22,1995,5.0,12,10,7,3,2,8,13,61.5,5,5,4,1,8,20,23,1,Matches,2018
324,Mateo Kovačić,hr CRO,MF,Real Madrid,23,1994,2.9,7,4,3,4,0,3,7,42.9,4,2,0,2,5,12,3,0,Matches,2018
325,Viktor Kovalenko,ua UKR,"MF,FW",Shakhtar,21,1996,0.5,0,0,0,0,0,0,1,0.0,1,1,0,1,0,0,0,0,Matches,2018
326,Martin Kramarič,si SVN,FW,NK Maribor,19,1997,1.1,2,1,2,0,0,1,4,25.0,3,4,0,4,4,6,0,1,Matches,2018
327,Michiel Kramer,nl NED,FW,Feyenoord,28,1988,0.9,2,2,0,2,0,0,0,,0,0,0,0,2,4,1,0,Matches,2018
328,Michael Krohn-Dehli,dk DEN,MF,Sevilla,34,1983,1.6,0,0,0,0,0,0,1,0.0,1,0,0,0,2,2,0,0,Matches,2018
329,Toni Kroos,de GER,MF,Real Madrid,27,1990,10.6,19,12,7,9,3,5,18,27.8,13,10,0,10,7,26,0,0,Matches,2018
330,Serhiy Kryvtsov,ua UKR,DF,Shakhtar,26,1991,0.5,0,0,0,0,0,0,0,,0,1,1,0,2,2,1,0,Matches,2018
331,Konstantin Kuchayev,ru RUS,"MF,FW",CSKA Moscow,19,1998,2.5,8,5,2,6,0,3,13,23.1,10,4,2,2,4,12,2,0,Matches,2018
332,Sven Kums,be BEL,MF,Anderlecht,29,1988,3.8,6,4,2,4,0,2,13,15.4,11,4,1,3,6,12,3,0,Matches,2018
333,Layvin Kurzawa,fr FRA,DF,Paris S-G,24,1992,6.0,9,4,5,1,3,2,6,33.3,4,8,1,7,5,14,14,0,Matches,2018
334,Ilya Kutepov,ru RUS,DF,Spartak Moscow,24,1993,3.0,11,9,5,6,0,7,8,87.5,1,4,2,2,13,24,14,0,Matches,2018
335,Léo Lacroix,ch SUI,DF,Basel,25,1992,2.0,3,2,2,1,0,0,0,,0,5,3,2,3,6,18,0,Matches,2018
336,Roberto Lago,es ESP,DF,APOEL FC,31,1985,5.0,11,9,9,2,0,8,14,57.1,6,12,2,10,10,21,16,0,Matches,2018
337,Konrad Laimer,at AUT,MF,RB Leipzig,20,1997,0.1,0,0,0,0,0,0,0,,0,0,0,0,0,0,0,0,Matches,2018
338,Adam Lallana,eng ENG,FW,Liverpool,29,1988,1.7,2,1,1,1,0,1,8,12.5,7,7,0,7,1,3,0,0,Matches,2018
339,Érik Lamela,ar ARG,"FW,MF",Tottenham,25,1992,1.2,2,1,0,0,2,0,3,0.0,3,1,0,1,2,4,1,0,Matches,2018
340,Michael Lang,ch SUI,"MF,DF",Basel,26,1991,8.0,12,8,6,3,3,7,11,63.6,4,5,2,3,14,26,15,0,Matches,2018
341,Aymeric Laporte,es ESP,DF,Manchester City,23,1994,3.0,13,9,9,3,1,5,12,41.7,7,1,0,1,2,15,16,0,Matches,2018
342,Sam Larsson,se SWE,FW,Feyenoord,24,1993,1.7,4,2,2,2,0,2,8,25.0,6,4,0,4,5,9,0,0,Matches,2018
343,Miguel Layún,mx MEX,"DF,MF",Porto,29,1988,1.2,4,2,1,3,0,1,1,100.0,0,1,0,1,2,6,6,0,Matches,2018
344,Thomas Lemar,fr FRA,"MF,FW",Monaco,21,1995,2.0,2,1,1,0,1,0,2,0.0,2,3,0,3,2,4,0,0,Matches,2018
345,Clément Lenglet,fr FRA,DF,Sevilla,22,1995,9.0,16,12,14,2,0,5,7,71.4,2,12,7,5,17,33,32,0,Matches,2018
346,Jeremain Lens,nl NED,FW,Beşiktaş,29,1987,1.7,1,1,0,1,0,0,3,0.0,3,0,0,0,0,1,1,0,Matches,2018
347,Robert Lewandowski,pl POL,FW,Bayern Munich,28,1988,10.6,7,6,0,2,5,0,12,0.0,12,7,1,6,2,9,3,0,Matches,2018
348,Stephan Lichtsteiner,ch SUI,DF,Juventus,33,1984,1.1,0,0,0,0,0,0,1,0.0,1,0,0,0,1,1,9,0,Matches,2018
349,Victor Lindelöf,se SWE,DF,Manchester Utd,23,1994,5.0,5,2,4,1,0,2,3,66.7,1,10,5,5,7,12,16,0,Matches,2018
350,Jesse Lingard,eng ENG,"MF,FW",Manchester Utd,24,1992,2.7,9,4,4,4,1,0,2,0.0,2,1,0,1,0,9,0,0,Matches,2018
351,Fernando Llorente,es ESP,FW,Tottenham,32,1985,2.5,1,0,0,0,1,1,3,33.3,2,1,0,1,0,1,5,0,Matches,2018
352,Marcos Llorente,es ESP,MF,Real Madrid,22,1995,0.2,0,0,0,0,0,0,1,0.0,1,0,0,0,1,1,0,0,Matches,2018
353,Hugo Lloris,fr FRA,GK,Tottenham,30,1986,7.0,0,0,0,0,0,0,0,,0,0,0,0,0,0,2,0,Matches,2018
354,Giovani Lo Celso,ar ARG,MF,Paris S-G,21,1996,1.7,5,2,3,0,2,3,9,33.3,6,1,0,1,1,6,2,0,Matches,2018
355,Rony Lopes,pt POR,"MF,FW",Monaco,21,1995,3.3,5,4,0,5,0,1,5,20.0,4,7,0,7,3,8,1,0,Matches,2018
356,Lisandro López,ar ARG,DF,Benfica,27,1989,2.0,6,5,4,2,0,6,6,100.0,0,2,1,1,4,10,8,0,Matches,2018
357,Vágner Love,br BRA,FW,Beşiktaş,33,1984,1.5,1,1,0,1,0,1,1,100.0,0,2,0,2,0,1,2,0,Matches,2018
358,Dejan Lovren,hr CRO,DF,Liverpool,28,1989,11.7,16,12,13,3,0,9,10,90.0,1,11,6,5,17,33,68,2,Matches,2018
359,Filipe Luís,br BRA,DF,Atlético Madrid,31,1985,6.0,22,14,13,8,1,8,13,61.5,5,8,1,7,13,35,4,1,Matches,2018
360,Zé Luís,cv CPV,FW,Spartak Moscow,26,1991,1.8,0,0,0,0,0,0,1,0.0,1,0,0,0,0,0,2,0,Matches,2018
361,Luisão,br BRA,DF,Benfica,36,1981,4.0,6,3,5,1,0,2,5,40.0,3,1,1,0,8,14,17,0,Matches,2018
362,David Luiz,br BRA,"DF,MF",Chelsea,30,1987,3.6,7,5,2,4,1,1,7,14.3,6,2,0,2,7,14,5,1,Matches,2018
363,Romelu Lukaku,be BEL,FW,Manchester Utd,24,1993,7.8,6,2,1,2,3,1,3,33.3,2,0,0,0,0,6,4,0,Matches,2018
364,Mikael Lustig,se SWE,DF,Celtic,30,1986,5.1,14,9,9,4,1,8,13,61.5,5,8,3,5,14,28,28,0,Matches,2018
365,Mahir Madatov,az AZE,"MF,FW",Qarabağ FK,20,1997,3.6,13,10,6,6,1,3,7,42.9,4,1,0,1,2,15,4,0,Matches,2018
366,Christian Maggio,it ITA,DF,Napoli,35,1982,2.6,8,5,3,5,0,2,7,28.6,5,0,0,0,2,10,4,0,Matches,2018
367,Abdul Majeed Waris,gh GHA,"MF,FW",Porto,25,1991,1.1,1,1,0,1,0,1,3,33.3,2,0,0,0,2,3,0,0,Matches,2018
368,Andreas Makris,cy CYP,FW,APOEL FC,21,1995,0.3,0,0,0,0,0,0,0,,0,0,0,0,2,2,0,0,Matches,2018
369,Nikola Maksimović,rs SRB,DF,Napoli,25,1991,1.0,0,0,0,0,0,0,1,0.0,1,0,0,0,2,2,4,0,Matches,2018
370,Tyrell Malacia,nl NED,DF,Feyenoord,17,1999,1.0,2,1,2,0,0,0,0,,0,1,1,0,1,3,3,0,Matches,2018
371,Mario Mandžukić,hr CRO,FW,Juventus,31,1986,5.1,8,5,3,4,1,2,5,40.0,3,4,0,4,4,12,8,0,Matches,2018
372,Sadio Mané,sn SEN,"FW,MF",Liverpool,25,1992,10.4,22,10,11,6,5,8,21,38.1,13,13,0,13,7,29,7,1,Matches,2018
373,Eliaquim Mangala,fr FRA,DF,Manchester City,26,1991,2.0,2,0,1,1,0,1,1,100.0,0,3,3,0,5,7,4,1,Matches,2018
374,Kostas Manolas,gr GRE,DF,Roma,26,1991,10.2,14,8,9,5,0,7,14,50.0,7,16,10,6,10,24,48,0,Matches,2018
375,Iván Marcano,es ESP,DF,Porto,30,1987,7.0,9,6,5,4,0,0,3,0.0,3,5,4,1,9,18,42,1,Matches,2018
376,Marcelo,br BRA,DF,Real Madrid,29,1988,10.6,17,9,6,9,2,9,26,34.6,17,13,2,11,15,32,11,0,Matches,2018
377,Claudio Marchisio,it ITA,FW,Juventus,31,1986,0.2,1,1,1,0,0,1,2,50.0,1,1,0,1,0,1,1,0,Matches,2018
378,Moussa Marega,ml MLI,FW,Porto,26,1991,4.9,5,3,2,2,1,2,3,66.7,1,1,0,1,5,10,3,0,Matches,2018
379,José María Giménez,uy URU,DF,Atlético Madrid,22,1995,3.0,9,8,7,2,0,6,13,46.2,7,5,1,4,6,15,18,0,Matches,2018
380,Marko Marin,de GER,"FW,MF",Olympiacos,28,1989,1.5,1,1,1,0,0,0,1,0.0,1,1,0,1,1,2,0,0,Matches,2018
381,Marlos,ua UKR,FW,Shakhtar,29,1988,7.4,9,6,3,4,2,2,15,13.3,13,7,0,7,2,11,1,0,Matches,2018
382,Marquinhos,br BRA,DF,Paris S-G,23,1994,8.0,9,6,4,4,1,1,4,25.0,3,9,4,5,10,19,42,0,Matches,2018
383,Anthony Martial,fr FRA,"FW,MF",Manchester Utd,21,1995,3.8,1,1,1,0,0,0,1,0.0,1,1,0,1,1,2,0,0,Matches,2018
384,Javi Martínez,es ESP,"MF,DF",Bayern Munich,28,1988,8.2,19,9,9,8,2,6,18,33.3,12,9,3,6,19,38,19,0,Matches,2018
385,Gelson Martins,pt POR,FW,Sporting CP,22,1995,5.1,8,5,2,5,1,1,5,20.0,4,3,0,3,4,12,5,0,Matches,2018
386,Javier Mascherano,ar ARG,DF,Barcelona,33,1984,1.5,2,2,0,2,0,1,3,33.3,2,1,1,0,1,3,1,0,Matches,2018
387,Juan Mata,es ESP,"FW,MF",Manchester Utd,29,1988,4.6,7,5,3,4,0,1,8,12.5,7,4,0,4,6,13,0,1,Matches,2018
388,Jérémy Mathieu,fr FRA,DF,Sporting CP,33,1983,4.9,6,4,4,1,1,3,4,75.0,1,5,3,2,6,12,21,0,Matches,2018
389,Nemanja Matić,rs SRB,MF,Manchester Utd,28,1988,6.3,17,11,7,10,0,8,13,61.5,5,5,1,4,14,31,7,0,Matches,2018
390,Joël Matip,cm CMR,DF,Liverpool,25,1991,5.2,4,3,3,1,0,1,6,16.7,5,2,2,0,8,12,11,0,Matches,2018
391,Blaise Matuidi,fr FRA,MF,Juventus,30,1987,5.5,7,5,3,4,0,2,10,20.0,8,4,1,3,9,16,4,0,Matches,2018
392,Borja Mayoral,es ESP,FW,Real Madrid,20,1997,1.6,1,1,0,1,0,1,2,50.0,1,0,0,0,0,1,2,0,Matches,2018
393,Kylian Mbappé,fr FRA,FW,Paris S-G,18,1998,7.3,2,2,1,1,0,0,1,0.0,1,5,0,5,4,6,1,0,Matches,2018
394,Kara Mbodji,sn SEN,DF,Anderlecht,27,1989,4.3,5,2,5,0,0,2,6,33.3,4,8,6,2,5,10,21,0,Matches,2018
395,Callum McGregor,sct SCO,MF,Celtic,24,1993,3.3,6,3,0,4,2,1,3,33.3,2,6,0,6,6,12,2,0,Matches,2018
396,Scott McTominay,sct SCO,MF,Manchester Utd,20,1996,2.3,3,1,0,3,0,2,6,33.3,4,4,0,4,3,6,4,0,Matches,2018
397,Gary Medel,cl CHI,"DF,MF",Beşiktaş,29,1987,4.8,6,3,5,1,0,2,8,25.0,6,4,3,1,6,12,21,0,Matches,2018
398,Maksim Medvedev,az AZE,DF,Qarabağ FK,27,1989,5.8,17,14,14,3,0,9,18,50.0,9,8,4,4,7,24,16,0,Matches,2018
399,Soualiho Meïté,fr FRA,MF,Monaco,23,1994,0.7,0,0,0,0,0,0,1,0.0,1,1,0,1,0,0,0,0,Matches,2018
400,Lorenzo Melgarejo,py PAR,"FW,MF",Spartak Moscow,26,1990,2.3,3,1,2,1,0,1,4,25.0,3,2,1,1,1,4,9,0,Matches,2018
401,Benjamin Mendy,fr FRA,DF,Manchester City,23,1994,1.0,0,0,0,0,0,0,2,0.0,2,0,0,0,0,0,0,0,Matches,2018
402,Gabriel Mercado,ar ARG,DF,Sevilla,30,1987,7.7,25,12,16,6,3,14,29,48.3,15,9,0,9,9,34,21,0,Matches,2018
403,Giorgos Merkis,cy CYP,DF,APOEL FC,33,1984,2.0,4,2,4,0,0,2,2,100.0,0,3,3,0,3,7,19,0,Matches,2018
404,Dries Mertens,be BEL,FW,Napoli,30,1987,5.3,4,3,0,3,1,1,9,11.1,8,1,0,1,3,7,2,0,Matches,2018
405,Jasmin Mešanović,ba BIH,"FW,MF",NK Maribor,25,1992,1.1,0,0,0,0,0,0,0,,0,0,0,0,0,0,0,0,Matches,2018
406,Lionel Messi,ar ARG,FW,Barcelona,30,1987,8.7,9,7,2,5,2,0,7,0.0,7,4,0,4,3,12,0,0,Matches,2018
407,Thomas Meunier,be BEL,DF,Paris S-G,25,1991,0.3,0,0,0,0,0,0,0,,0,1,0,1,0,0,0,0,Matches,2018
408,Míchel,es ESP,MF,Qarabağ FK,31,1985,5.9,13,11,4,8,1,3,8,37.5,5,8,1,7,9,22,12,0,Matches,2018
409,Georgi Milanov,bg BUL,MF,CSKA Moscow,25,1992,1.0,2,1,1,1,0,0,1,0.0,1,3,0,3,2,4,1,0,Matches,2018
410,Martin Milec,si SVN,DF,NK Maribor,25,1991,6.0,12,9,10,2,0,7,16,43.8,9,8,0,8,13,25,21,1,Matches,2018
411,Arkadiusz Milik,pl POL,FW,Napoli,23,1994,1.0,0,0,0,0,0,0,0,,0,0,0,0,0,0,0,0,Matches,2018
412,James Milner,eng ENG,MF,Liverpool,31,1986,9.7,25,14,12,9,4,7,32,21.9,25,18,6,12,11,36,11,0,Matches,2018
413,Matej Mitrović,hr CRO,DF,Beşiktaş,23,1993,1.2,2,2,1,1,0,2,2,100.0,0,2,2,0,4,6,13,0,Matches,2018
414,Henrikh Mkhitaryan,am ARM,MF,Manchester Utd,28,1989,3.2,10,7,1,6,3,2,9,22.2,7,6,0,6,3,13,1,0,Matches,2018
415,Luka Modrić,hr CRO,MF,Real Madrid,31,1985,10.6,15,8,5,8,2,5,18,27.8,13,9,2,7,14,29,4,0,Matches,2018
416,Nuno Morais,pt POR,"MF,DF",APOEL FC,33,1984,5.7,11,9,5,6,0,3,18,16.7,15,9,6,3,5,16,13,0,Matches,2018
417,Álvaro Morata,es ESP,FW,Chelsea,24,1992,4.3,1,1,0,1,0,0,4,0.0,4,1,0,1,1,2,6,0,Matches,2018
418,Alberto Moreno,es ESP,DF,Liverpool,25,1992,6.3,17,11,8,6,3,9,14,64.3,5,6,0,6,9,26,27,0,Matches,2018
419,Victor Moses,ng NGA,DF,Chelsea,26,1990,3.7,9,7,6,3,0,7,9,77.8,2,1,0,1,2,11,9,0,Matches,2018
420,Thiago Motta,it ITA,MF,Paris S-G,34,1982,3.4,7,6,4,3,0,3,11,27.3,8,8,1,7,2,9,6,1,Matches,2018
421,Lucas Moura,br BRA,FW,Tottenham,24,1992,0.0,0,0,0,0,0,0,0,,0,0,0,0,0,0,0,0,Matches,2018
422,João Moutinho,pt POR,MF,Monaco,30,1986,5.2,15,6,5,8,2,7,17,41.2,10,6,3,3,7,22,8,0,Matches,2018
423,Thomas Müller,de GER,"MF,FW",Bayern Munich,27,1989,8.2,10,8,4,5,1,4,8,50.0,4,8,0,8,4,14,5,0,Matches,2018
424,Luis Muriel,co COL,FW,Sevilla,26,1991,2.8,3,1,0,2,1,0,4,0.0,4,1,0,1,2,5,0,0,Matches,2018
425,Kévin N'Doram,fr FRA,MF,Monaco,21,1996,1.0,0,0,0,0,0,0,2,0.0,2,1,0,1,1,1,0,0,Matches,2018
426,Georges-Kévin N'Koudou,cm CMR,"MF,FW",Tottenham,22,1995,1.2,0,0,0,0,0,0,1,0.0,1,0,0,0,0,0,0,0,Matches,2018
427,Kirill Nababkin,ru RUS,MF,CSKA Moscow,30,1986,1.4,2,2,2,0,0,0,4,0.0,4,1,0,1,1,3,5,0,Matches,2018
428,Ben Nabouhane,km COM,FW,Olympiacos,28,1989,0.4,0,0,0,0,0,0,0,,0,0,0,0,0,0,1,0,Matches,2018
429,Nacho,es ESP,DF,Real Madrid,27,1990,6.6,22,15,14,7,1,8,18,44.4,10,4,2,2,13,35,18,0,Matches,2018
430,Radja Nainggolan,be BEL,MF,Roma,29,1988,10.7,18,11,3,11,4,6,16,37.5,10,10,0,10,4,22,4,2,Matches,2018
431,Andy Najar,hn HON,DF,Anderlecht,24,1993,0.3,1,1,1,0,0,1,1,100.0,0,0,0,0,0,1,1,0,Matches,2018
432,Bibras Natkho,il ISR,MF,CSKA Moscow,29,1988,2.6,9,5,4,4,1,3,9,33.3,6,2,1,1,6,15,3,0,Matches,2018
433,Jesús Navas,es ESP,"DF,FW",Sevilla,31,1985,4.7,3,1,2,1,0,0,2,0.0,2,2,0,2,8,11,16,0,Matches,2018
434,Keylor Navas,cr CRC,GK,Real Madrid,30,1986,11.0,0,0,0,0,0,0,0,,0,0,0,0,2,2,1,2,Matches,2018
435,Dino Ndlovu,za RSA,FW,Qarabağ FK,27,1990,4.7,4,2,0,3,1,0,3,0.0,3,1,1,0,2,6,3,0,Matches,2018
436,Álvaro Negredo,es ESP,FW,Beşiktaş,31,1985,1.2,0,0,0,0,0,0,2,0.0,2,2,0,2,0,0,3,0,Matches,2018
437,Miquel Nelom,nl NED,DF,Feyenoord,26,1990,1.0,2,2,2,0,0,2,3,66.7,1,1,0,1,1,3,4,0,Matches,2018
438,Manuel Neuer,de GER,GK,Bayern Munich,31,1986,1.0,0,0,0,0,0,0,0,,0,0,0,0,0,0,0,0,Matches,2018
439,Neymar,br BRA,FW,Paris S-G,25,1992,7.0,11,6,2,6,3,2,8,25.0,6,7,0,7,1,12,0,0,Matches,2018
440,Bart Nieuwkoop,nl NED,DF,Feyenoord,21,1996,2.7,9,7,8,0,1,2,4,50.0,2,6,4,2,16,25,12,0,Matches,2018
441,Saúl Ñíguez,es ESP,MF,Atlético Madrid,22,1994,6.0,20,14,6,11,3,9,19,47.4,10,14,3,11,14,34,19,0,Matches,2018
442,Dimitris Nikolaou,gr GRE,DF,Olympiacos,18,1998,3.0,3,3,3,0,0,0,1,0.0,1,6,3,3,5,8,15,0,Matches,2018
443,Nolito,es ESP,FW,Sevilla,30,1986,3.5,4,2,2,1,1,2,7,28.6,5,2,0,2,3,7,3,0,Matches,2018
444,Olivier Ntcham,cm CMR,MF,Celtic,21,1996,4.3,15,12,5,8,2,3,9,33.3,6,2,1,1,3,18,4,3,Matches,2018
445,Steven Nzonzi,fr FRA,MF,Sevilla,28,1988,7.5,11,8,7,3,1,2,9,22.2,7,11,4,7,12,23,16,0,Matches,2018
446,Dimitri Oberlin,ch SUI,FW,Basel,19,1997,5.9,12,7,4,7,1,3,12,25.0,9,10,0,10,4,16,7,0,Matches,2018
447,Jan Oblak,si SVN,GK,Atlético Madrid,24,1993,6.0,0,0,0,0,0,0,0,,0,0,0,0,0,0,1,0,Matches,2018
448,Ivan Obradović,rs SRB,DF,Anderlecht,29,1988,2.0,2,1,1,1,0,1,3,33.3,2,1,1,0,1,3,3,0,Matches,2018
449,Vadis Odjidja-Ofoe,be BEL,"MF,FW",Olympiacos,28,1989,4.6,10,8,7,2,1,0,7,0.0,7,6,1,5,4,14,3,0,Matches,2018
450,Mattheus Oliveira,br BRA,FW,Sporting CP,23,1994,0.0,0,0,0,0,0,0,0,,0,0,0,0,0,0,0,0,Matches,2018
451,Sérgio Oliveira,pt POR,MF,Porto,25,1992,3.9,22,18,9,12,1,7,13,53.8,6,4,1,3,3,25,6,0,Matches,2018
452,Henry Onyekuru,ng NGA,"FW,MF",Anderlecht,20,1997,4.5,1,1,1,0,0,1,2,50.0,1,5,0,5,1,2,0,0,Matches,2018
453,Willi Orban,hu HUN,DF,RB Leipzig,24,1992,5.3,10,8,4,5,1,5,11,45.5,6,10,2,8,7,17,30,0,Matches,2018
454,Ivan Ordets,ua UKR,DF,Shakhtar,25,1992,7.4,14,8,9,5,0,3,7,42.9,4,5,4,1,14,28,44,0,Matches,2018
455,Nicolás Otamendi,ar ARG,DF,Manchester City,29,1988,8.0,17,14,11,5,1,7,13,53.8,6,5,3,2,18,35,39,1,Matches,2018
456,Otávio,pt POR,MF,Porto,22,1995,1.0,0,0,0,0,0,0,2,0.0,2,0,0,0,1,1,0,0,Matches,2018
457,Adam Ounas,dz ALG,"FW,MF",Napoli,20,1996,0.4,2,2,1,1,0,0,1,0.0,1,0,0,0,0,2,0,0,Matches,2018
458,Alex Oxlade-Chamberlain,eng ENG,"FW,MF",Liverpool,23,1993,3.6,7,4,4,3,0,2,8,25.0,6,7,2,5,3,10,5,0,Matches,2018
459,Oğuzhan Özyakup,tr TUR,MF,Beşiktaş,24,1992,4.9,10,6,2,8,0,5,15,33.3,10,12,3,9,9,19,6,0,Matches,2018
460,Gonçalo Paciência,pt POR,FW,Porto,22,1994,0.3,2,1,0,2,0,0,1,0.0,1,0,0,0,0,2,0,0,Matches,2018
461,João Palhinha,pt POR,MF,Sporting CP,22,1995,0.4,0,0,0,0,0,0,3,0.0,3,1,1,0,2,2,4,0,Matches,2018
462,Sokratis Papastathopoulos,gr GRE,DF,Dortmund,29,1988,5.0,13,8,11,2,0,4,8,50.0,4,4,2,2,8,21,25,0,Matches,2018
463,Felipe Pardo,co COL,"MF,FW",Olympiacos,26,1990,3.3,1,1,0,0,1,0,2,0.0,2,4,0,4,3,4,3,0,Matches,2018
464,Nicolás Pareja,ar ARG,DF,Sevilla,33,1984,2.0,6,3,2,4,0,4,4,100.0,0,5,3,2,6,12,8,0,Matches,2018
465,Thomas Partey,gh GHA,"MF,DF",Atlético Madrid,24,1993,4.8,9,6,6,3,0,4,15,26.7,11,6,3,3,6,15,6,1,Matches,2018
466,Mario Pašalić,hr CRO,MF,Spartak Moscow,22,1995,3.9,13,8,7,6,0,5,12,41.7,7,5,1,4,7,20,2,0,Matches,2018
467,Javier Pastore,ar ARG,"MF,FW",Paris S-G,28,1989,0.8,1,0,0,0,1,0,2,0.0,2,4,0,4,2,3,0,0,Matches,2018
468,Rui Patrício,pt POR,GK,Sporting CP,29,1988,6.0,0,0,0,0,0,0,0,,0,0,0,0,2,2,4,1,Matches,2018
469,Alan Patrick,br BRA,MF,Shakhtar,26,1991,0.6,3,2,1,1,1,2,2,100.0,0,0,0,0,1,4,1,0,Matches,2018
470,Paulinho,br BRA,MF,Barcelona,29,1988,4.5,11,6,5,2,4,1,10,10.0,9,2,1,1,5,16,5,0,Matches,2018
471,Pedro,es ESP,"MF,FW",Chelsea,30,1987,4.3,7,4,6,1,0,2,9,22.2,7,0,0,0,9,16,1,0,Matches,2018
472,Mustafa Pektemek,tr TUR,"FW,MF",Beşiktaş,28,1988,1.8,3,1,2,1,0,1,3,33.3,2,1,0,1,2,5,1,0,Matches,2018
473,Lorenzo Pellegrini,it ITA,"MF,FW",Roma,21,1996,3.3,5,3,1,4,0,1,3,33.3,2,4,1,3,4,9,2,0,Matches,2018
474,Pepe,pt POR,DF,Beşiktaş,34,1983,6.0,16,11,7,8,1,3,7,42.9,4,16,12,4,13,29,41,2,Matches,2018
475,Danilo Pereira,pt POR,MF,Porto,25,1991,5.9,13,11,7,6,0,3,11,27.3,8,7,4,3,10,23,8,0,Matches,2018
476,Maxi Pereira,uy URU,"DF,MF",Porto,33,1984,2.2,4,2,3,1,0,1,5,20.0,4,2,0,2,5,9,6,0,Matches,2018
477,Ricardo Pereira,pt POR,"DF,FW",Porto,23,1993,6.1,18,13,13,4,1,8,16,50.0,8,11,2,9,12,30,12,0,Matches,2018
478,Bruno Peres,br BRA,DF,Roma,27,1990,5.1,10,8,7,2,1,5,9,55.6,4,5,2,3,11,21,12,0,Matches,2018
479,Nauzet Pérez,es ESP,GK,APOEL FC,32,1985,3.0,1,0,1,0,0,1,1,100.0,0,0,0,0,1,2,5,2,Matches,2018
480,Diego Perotti,ar ARG,FW,Roma,29,1988,8.1,17,12,8,5,4,7,26,26.9,19,9,0,9,8,25,3,0,Matches,2018
481,Marko Petković,rs SRB,DF,Spartak Moscow,24,1992,0.9,2,0,2,0,0,1,1,100.0,0,2,0,2,2,4,2,0,Matches,2018
482,Raoul Petretta,it ITA,MF,Basel,20,1997,4.6,9,6,5,3,1,1,3,33.3,2,12,3,9,8,17,11,0,Matches,2018
483,Radosav Petrović,rs SRB,"MF,DF",Sporting CP,28,1989,0.0,0,0,0,0,0,0,0,,0,0,0,0,0,0,0,0,Matches,2018
484,Ivan Petryak,ua UKR,FW,Shakhtar,23,1994,0.0,0,0,0,0,0,0,0,,0,0,0,0,0,0,0,0,Matches,2018
485,Maximilian Philipp,de GER,"FW,MF",Dortmund,23,1994,1.9,4,2,0,1,3,0,0,,0,2,0,2,0,4,1,0,Matches,2018
486,Cristiano Piccini,it ITA,DF,Sporting CP,24,1992,4.9,8,5,3,5,0,2,3,66.7,1,16,3,13,8,16,12,0,Matches,2018
487,Aleks Pihler,si SVN,MF,NK Maribor,23,1994,4.4,7,5,4,3,0,2,5,40.0,3,5,2,3,3,10,10,0,Matches,2018
488,Gerard Piqué,es ESP,DF,Barcelona,30,1987,8.2,12,9,9,3,0,5,7,71.4,2,9,7,2,6,18,38,0,Matches,2018
489,Łukasz Piszczek,pl POL,DF,Dortmund,32,1985,2.0,2,1,0,2,0,0,1,0.0,1,1,0,1,5,7,7,0,Matches,2018
490,Guido Pizarro,ar ARG,MF,Sevilla,27,1990,5.6,14,9,1,8,5,6,18,33.3,12,7,0,7,2,16,6,1,Matches,2018
491,Pizzi,pt POR,MF,Benfica,27,1989,5.3,9,5,3,6,0,5,18,27.8,13,6,2,4,2,11,2,1,Matches,2018
492,Miralem Pjanić,ba BIH,MF,Juventus,27,1990,7.0,10,9,5,3,2,0,15,0.0,15,15,6,9,8,18,9,0,Matches,2018
493,Paul Pogba,fr FRA,MF,Manchester Utd,24,1993,3.1,8,5,1,6,1,1,3,33.3,2,1,1,0,3,11,2,0,Matches,2018
494,Ivelin Popov,bg BUL,MF,Spartak Moscow,29,1987,2.7,5,2,1,4,0,2,4,50.0,2,4,0,4,1,6,1,0,Matches,2018
495,Mickaël Poté,bj BEN,FW,APOEL FC,32,1984,3.5,3,2,2,1,0,1,3,33.3,2,5,0,5,2,5,4,0,Matches,2018
496,Yussuf Poulsen,dk DEN,FW,RB Leipzig,23,1994,2.2,2,2,0,2,0,0,1,0.0,1,0,0,0,0,2,2,0,Matches,2018
497,Quincy Promes,nl NED,"FW,MF",Spartak Moscow,25,1992,4.8,2,0,1,0,1,2,5,40.0,3,4,0,4,2,4,0,0,Matches,2018
498,Silvio Proto,be BEL,GK,Olympiacos,34,1983,5.0,0,0,0,0,0,0,0,,0,0,0,0,2,2,4,0,Matches,2018
499,Christian Pulisic,us USA,"FW,MF",Dortmund,18,1998,4.2,6,5,1,2,3,1,5,20.0,4,3,0,3,2,8,0,0,Matches,2018
500,Andriy Pyatov,ua UKR,GK,Shakhtar,33,1984,8.0,1,0,1,0,0,1,2,50.0,1,0,0,0,1,2,4,1,Matches,2018
501,Ricardo Quaresma,pt POR,FW,Beşiktaş,33,1983,6.8,8,4,2,6,0,1,5,20.0,4,4,0,4,3,11,1,0,Matches,2018
502,Dani Quintana,es ESP,"FW,MF",Qarabağ FK,30,1987,0.4,0,0,0,0,0,0,3,0.0,3,0,0,0,0,0,0,0,Matches,2018
503,Adrien Rabiot,fr FRA,MF,Paris S-G,22,1995,7.5,12,10,6,6,0,2,10,20.0,8,10,1,9,12,24,18,1,Matches,2018
504,Rafinha,br BRA,DF,Bayern Munich,31,1985,5.6,17,11,9,5,3,8,14,57.1,6,2,0,2,13,30,13,1,Matches,2018
505,Andrea Raggi,it ITA,DF,Monaco,33,1984,2.0,3,0,1,2,0,2,2,100.0,0,2,0,2,3,6,3,0,Matches,2018
506,Aleksander Rajčević,si SVN,DF,NK Maribor,30,1986,4.0,1,0,1,0,0,0,2,0.0,2,5,5,0,7,8,21,0,Matches,2018
507,Ivan Rakitić,hr CRO,MF,Barcelona,29,1988,8.4,13,8,4,6,3,4,16,25.0,12,5,1,4,16,29,2,1,Matches,2018
508,Yaroslav Rakitskiy,ua UKR,DF,Shakhtar,27,1989,6.8,9,7,7,2,0,5,7,71.4,2,6,4,2,13,22,25,0,Matches,2018
509,Anthony Ralston,sct SCO,DF,Celtic,18,1998,1.0,3,2,0,3,0,2,4,50.0,2,1,1,0,1,4,6,0,Matches,2018
510,Aghabala Ramazanov,az AZE,MF,Qarabağ FK,24,1993,0.1,0,0,0,0,0,0,1,0.0,1,0,0,0,0,0,0,0,Matches,2018
511,Sandro Ramírez,es ESP,FW,Sevilla,22,1995,0.4,1,1,0,1,0,1,2,50.0,1,2,0,2,0,1,0,0,Matches,2018
512,Sergio Ramos,es ESP,DF,Real Madrid,31,1986,11.0,19,14,15,4,0,6,19,31.6,13,20,13,7,18,37,49,1,Matches,2018
513,Marcus Rashford,eng ENG,"FW,MF",Manchester Utd,19,1997,3.8,4,2,2,2,0,1,5,20.0,4,3,0,3,1,5,0,0,Matches,2018
514,Artyom Rebrov,ru RUS,GK,Spartak Moscow,33,1984,1.8,0,0,0,0,0,0,0,,0,0,0,0,0,0,0,0,Matches,2018
515,Pepe Reina,es ESP,GK,Napoli,34,1982,6.0,0,0,0,0,0,0,0,,0,0,0,0,0,0,2,1,Matches,2018
516,Diego Reyes,mx MEX,DF,Porto,24,1992,2.6,5,4,3,2,0,0,0,,0,5,3,2,4,9,13,0,Matches,2018
517,Franck Ribéry,fr FRA,"MF,FW",Bayern Munich,34,1983,6.4,4,2,2,1,1,1,10,10.0,9,5,0,5,4,8,4,0,Matches,2018
518,Sergio Rico,es ESP,GK,Sevilla,23,1993,8.0,0,0,0,0,0,0,0,,0,0,0,0,0,0,2,0,Matches,2018
519,Stefan Ristovski,mk MKD,DF,Sporting CP,25,1992,1.6,5,5,3,2,0,2,2,100.0,0,2,1,1,6,11,5,0,Matches,2018
520,Blas Riveros,py PAR,"DF,MF",Basel,19,1998,3.2,7,5,7,0,0,6,12,50.0,6,1,1,0,5,12,11,0,Matches,2018
521,Arjen Robben,nl NED,"FW,MF",Bayern Munich,33,1984,5.5,5,4,2,2,1,1,7,14.3,6,4,0,4,1,6,1,0,Matches,2018
522,Sergi Roberto,es ESP,"MF,DF",Barcelona,25,1992,6.6,15,12,5,5,5,5,13,38.5,8,8,1,7,4,19,4,0,Matches,2018
523,Patrick Roberts,eng ENG,FW,Celtic,20,1997,2.6,9,7,6,2,1,4,12,33.3,8,2,0,2,1,10,2,0,Matches,2018
524,Andrew Robertson,sct SCO,DF,Liverpool,23,1994,6.0,11,4,9,2,0,6,16,37.5,10,8,4,4,5,16,28,0,Matches,2018
525,Pedro Rocha Neves,br BRA,MF,Spartak Moscow,22,1994,0.0,0,0,0,0,0,0,0,,0,0,0,0,0,0,0,0,Matches,2018
526,James Rodríguez,co COL,"MF,FW",Bayern Munich,26,1991,8.7,18,12,4,7,7,8,24,33.3,16,11,0,11,9,27,0,0,Matches,2018
527,Marko Rog,hr CRO,"MF,FW",Napoli,22,1995,0.8,2,1,1,1,0,0,2,0.0,2,1,0,1,2,4,0,0,Matches,2018
528,Tom Rogić,au AUS,"MF,FW",Celtic,24,1992,3.3,6,6,1,5,0,4,6,66.7,2,4,0,4,3,9,0,0,Matches,2018
529,Marcos Rojo,ar ARG,DF,Manchester Utd,27,1990,1.0,1,0,1,0,0,1,2,50.0,1,1,1,0,3,4,3,0,Matches,2018
530,Alaixys Romao,tg TOG,"MF,DF",Olympiacos,33,1984,6.0,15,12,9,6,0,6,17,35.3,11,8,2,6,7,22,8,0,Matches,2018
531,Sergio Romero,ar ARG,GK,Manchester Utd,30,1987,2.0,0,0,0,0,0,0,0,,0,0,0,0,0,0,0,0,Matches,2018
532,Cristiano Ronaldo,pt POR,FW,Real Madrid,32,1985,13.0,5,2,1,4,0,1,4,25.0,3,8,3,5,3,8,10,0,Matches,2018
533,Danny Rose,eng ENG,DF,Tottenham,27,1990,1.9,9,7,4,5,0,5,5,100.0,0,4,1,3,3,12,4,0,Matches,2018
534,Antonio Rüdiger,de GER,DF,Chelsea,24,1993,4.3,7,7,3,4,0,3,8,37.5,5,1,0,1,6,13,11,1,Matches,2018
535,Sebastian Rudy,de GER,MF,Bayern Munich,27,1990,3.8,10,6,4,5,1,4,14,28.6,10,2,0,2,6,16,3,0,Matches,2018
536,Jesús Rueda,es ESP,DF,APOEL FC,30,1987,6.0,12,8,11,1,0,5,9,55.6,4,10,8,2,10,22,39,2,Matches,2018
537,Daniele Rugani,it ITA,DF,Juventus,23,1994,1.2,1,1,0,0,1,0,0,,0,2,1,1,0,1,4,0,Matches,2018
538,Mário Rui,pt POR,"DF,FW",Napoli,26,1991,0.3,1,1,0,0,1,0,1,0.0,1,0,0,0,1,2,1,0,Matches,2018
539,Alan Ruiz,ar ARG,FW,Sporting CP,23,1993,0.5,1,0,0,1,0,0,0,,0,0,0,0,0,1,0,0,Matches,2018
540,Jakub Rzeźniczak,pl POL,DF,Qarabağ FK,30,1986,4.2,10,6,9,1,0,7,8,87.5,1,6,6,0,15,25,21,0,Matches,2018
541,José Sá,pt POR,GK,Porto,24,1993,5.0,0,0,0,0,0,0,1,0.0,1,0,0,0,0,0,4,2,Matches,2018
542,Josué Sá,pt POR,DF,Anderlecht,25,1992,1.0,2,2,2,0,0,2,3,66.7,1,2,1,1,1,3,4,1,Matches,2018
543,Marcel Sabitzer,at AUT,"MF,FW",RB Leipzig,23,1994,4.4,8,5,2,5,1,1,7,14.3,6,3,0,3,2,10,4,0,Matches,2018
544,Rashad Sadygov,az AZE,DF,Qarabağ FK,35,1982,4.0,2,1,1,1,0,0,0,,0,10,8,2,6,8,16,0,Matches,2018
545,Nuri Şahin,tr TUR,MF,Dortmund,28,1988,2.4,4,2,2,1,1,2,7,28.6,5,3,3,0,9,13,1,0,Matches,2018
546,Mohamed Salah,eg EGY,FW,Liverpool,25,1992,10.3,6,4,1,3,2,0,7,0.0,7,4,0,4,5,11,3,0,Matches,2018
547,Roland Sallai,hu HUN,"MF,FW",APOEL FC,20,1997,3.2,1,1,1,0,0,0,3,0.0,3,3,1,2,2,3,5,0,Matches,2018
548,Eduardo Salvio,ar ARG,"MF,FW",Benfica,27,1990,4.4,9,7,4,3,2,3,4,75.0,1,4,0,4,8,17,3,0,Matches,2018
549,Andreas Samaris,gr GRE,MF,Benfica,28,1989,2.0,4,3,0,4,0,1,3,33.3,2,5,0,5,3,7,0,1,Matches,2018
550,Aleksandr Samedov,ru RUS,"MF,FW",Spartak Moscow,33,1984,2.1,0,0,0,0,0,0,4,0.0,4,2,0,2,2,2,6,0,Matches,2018
551,Aaron Samuel Olanare,ng NGA,FW,CSKA Moscow,23,1994,0.7,0,0,0,0,0,0,0,,0,2,0,2,0,0,0,0,Matches,2018
552,Alexis Sánchez,cl CHI,"FW,MF",Manchester Utd,28,1988,1.8,4,3,0,4,0,0,6,0.0,6,2,0,2,2,6,0,0,Matches,2018
553,Davinson Sánchez,co COL,DF,Tottenham,21,1996,8.0,7,5,3,4,0,3,11,27.3,8,11,6,5,16,23,31,0,Matches,2018
554,Alex Sandro,br BRA,DF,Juventus,26,1991,10.0,30,18,18,6,6,6,15,40.0,9,9,3,6,8,38,14,1,Matches,2018
555,Leroy Sané,de GER,"FW,MF",Manchester City,21,1996,7.3,7,6,0,4,3,1,4,25.0,3,12,0,12,3,10,1,1,Matches,2018
556,Pablo Sarabia,es ESP,FW,Sevilla,25,1992,8.2,11,7,3,5,3,2,21,9.5,19,10,1,9,9,20,7,0,Matches,2018
557,Stefan Savić,me MNE,DF,Atlético Madrid,26,1991,3.0,3,3,1,1,1,0,3,0.0,3,4,3,1,6,9,10,0,Matches,2018
558,Patrik Schick,cz CZE,"FW,MF",Roma,21,1996,2.3,3,3,0,3,0,1,4,25.0,3,4,0,4,0,3,0,0,Matches,2018
559,Marcel Schmelzer,de GER,DF,Dortmund,29,1988,3.0,5,4,3,1,1,4,5,80.0,1,3,2,1,11,16,10,0,Matches,2018
560,André Schürrle,de GER,DF,Dortmund,26,1990,0.0,0,0,0,0,0,0,0,,0,0,0,0,0,0,0,0,Matches,2018
561,Sebá,br BRA,"FW,MF",Olympiacos,25,1992,2.0,5,3,2,3,0,0,6,0.0,6,4,0,4,1,6,4,0,Matches,2018
562,Haris Seferović,ch SUI,FW,Benfica,25,1992,2.4,0,0,0,0,0,0,1,0.0,1,1,0,1,1,1,1,0,Matches,2018
563,Ibrahim Šehić,ba BIH,GK,Qarabağ FK,28,1988,6.0,0,0,0,0,0,0,0,,0,0,0,0,1,1,3,1,Matches,2018
564,Aleksandr Selikhov,ru RUS,GK,Spartak Moscow,23,1994,4.2,1,1,1,0,0,1,1,100.0,0,0,0,0,0,1,1,0,Matches,2018
565,Matz Sels,be BEL,GK,Anderlecht,25,1992,3.0,1,0,1,0,0,1,2,50.0,1,0,0,0,0,1,1,0,Matches,2018
566,Nélson Semedo,pt POR,DF,Barcelona,23,1993,6.9,15,13,11,4,0,8,17,47.1,9,8,1,7,8,23,15,0,Matches,2018
567,Stephan El Shaarawy,it ITA,FW,Roma,24,1992,4.0,2,1,2,0,0,0,2,0.0,2,1,0,1,4,6,1,0,Matches,2018
568,Luke Shaw,eng ENG,DF,Manchester Utd,22,1995,1.0,0,0,0,0,0,0,1,0.0,1,2,0,2,2,2,7,0,Matches,2018
569,Georgi Shchennikov,ru RUS,"FW,DF",CSKA Moscow,26,1991,4.6,6,4,5,1,0,4,9,44.4,5,3,0,3,12,18,12,0,Matches,2018
570,Ramil Sheydayev,az AZE,FW,Qarabağ FK,21,1996,0.9,1,1,0,1,0,1,3,33.3,2,0,0,0,0,1,0,0,Matches,2018
571,Djibril Sidibé,fr FRA,"DF,FW",Monaco,25,1992,2.8,6,4,3,3,0,1,4,25.0,3,3,1,2,5,11,6,0,Matches,2018
572,Bernardo Silva,pt POR,"FW,MF",Manchester City,22,1994,6.3,10,3,3,3,4,3,17,17.6,14,6,1,5,5,15,2,0,Matches,2018
573,David Silva,es ESP,MF,Manchester City,31,1986,4.7,3,1,2,1,0,1,1,100.0,0,2,0,2,6,9,2,0,Matches,2018
574,Jonathan Silva,ar ARG,DF,Sporting CP,23,1994,2.3,9,7,7,2,0,7,8,87.5,1,4,0,4,2,11,5,0,Matches,2018
575,Rafa Silva,pt POR,DF,Benfica,24,1993,0.0,0,0,0,0,0,0,0,,0,0,0,0,0,0,0,0,Matches,2018
576,Thiago Silva,br BRA,DF,Paris S-G,32,1984,5.8,5,3,4,1,0,3,4,75.0,1,8,4,4,4,9,30,0,Matches,2018
577,Jozo Šimunović,hr CRO,DF,Celtic,22,1994,4.0,3,1,2,1,0,2,3,66.7,1,0,0,0,14,17,22,0,Matches,2018
578,Scott Sinclair,eng ENG,"FW,MF",Celtic,28,1989,4.2,2,1,1,1,0,0,5,0.0,5,2,0,2,1,3,4,0,Matches,2018
579,Moussa Sissoko,fr FRA,MF,Tottenham,27,1989,3.8,9,6,5,3,1,5,9,55.6,4,1,0,1,4,13,8,0,Matches,2018
580,Chris Smalling,eng ENG,DF,Manchester Utd,27,1989,8.0,10,5,6,3,1,4,7,57.1,3,14,10,4,3,13,27,0,Matches,2018
581,Tiquinho Soares,br BRA,FW,Porto,26,1991,2.0,0,0,0,0,0,0,0,,0,0,0,0,1,1,0,0,Matches,2018
582,Dominic Solanke,eng ENG,"FW,MF",Liverpool,19,1997,0.4,1,0,1,0,0,0,1,0.0,1,1,0,1,0,1,0,0,Matches,2018
583,David Soria,es ESP,GK,Sevilla,24,1993,2.0,0,0,0,0,0,0,0,,0,0,0,0,0,0,2,0,Matches,2018
584,Uroš Spajić,rs SRB,DF,Anderlecht,24,1993,4.0,2,2,2,0,0,1,2,50.0,1,6,6,0,10,12,25,0,Matches,2018
585,Darijo Srna,hr CRO,DF,Shakhtar,35,1982,1.0,0,0,0,0,0,0,0,,0,1,1,0,2,2,4,0,Matches,2018
586,Jerry St. Juste,nl NED,DF,Feyenoord,20,1996,4.2,8,4,7,1,0,3,3,100.0,0,4,0,4,8,16,15,0,Matches,2018
587,Nicolae Stanciu,ro ROU,"MF,FW",Anderlecht,24,1993,1.1,2,1,2,0,0,2,3,66.7,1,1,0,1,0,2,0,0,Matches,2018
588,Renato Steffen,ch SUI,FW,Basel,25,1991,6.0,7,5,1,5,1,3,8,37.5,5,2,0,2,6,13,4,0,Matches,2018
589,Taras Stepanenko,ua UKR,MF,Shakhtar,27,1989,7.6,18,11,10,8,0,5,15,33.3,10,6,4,2,14,32,9,0,Matches,2018
590,Kazaiah Sterling,eng ENG,MF,Tottenham,18,1998,0.0,0,0,0,0,0,0,0,,0,0,0,0,0,0,0,0,Matches,2018
591,Raheem Sterling,eng ENG,"FW,MF",Manchester City,22,1994,5.5,4,2,1,2,1,0,3,0.0,3,8,0,8,5,9,0,0,Matches,2018
592,Valentin Stocker,ch SUI,MF,Basel,28,1989,1.0,0,0,0,0,0,0,1,0.0,1,1,0,1,3,3,0,0,Matches,2018
593,John Stones,eng ENG,DF,Manchester City,23,1994,5.0,3,2,2,1,0,2,4,50.0,2,8,6,2,6,9,25,0,Matches,2018
594,Kevin Strootman,nl NED,MF,Roma,27,1990,9.3,21,15,9,9,3,5,22,22.7,17,11,3,8,12,33,2,0,Matches,2018
595,Stefano Sturaro,it ITA,DF,Juventus,24,1993,2.6,7,4,3,3,1,4,7,57.1,3,2,1,1,0,7,4,0,Matches,2018
596,Daniel Sturridge,eng ENG,FW,Liverpool,27,1989,0.9,0,0,0,0,0,0,0,,0,0,0,0,0,0,1,0,Matches,2018
597,Denis Suárez,es ESP,MF,Barcelona,23,1994,1.9,1,0,0,0,1,0,6,0.0,6,1,0,1,0,1,0,0,Matches,2018
598,Luis Suárez,uy URU,FW,Barcelona,30,1987,9.8,4,4,1,1,2,1,10,10.0,9,5,0,5,2,6,5,0,Matches,2018
599,Danijel Subašić,hr CRO,GK,Monaco,32,1984,3.0,0,0,0,0,0,0,0,,0,0,0,0,0,0,0,0,Matches,2018
600,Neven Subotić,rs SRB,DF,Dortmund,28,1988,1.0,0,0,0,0,0,0,0,,0,2,2,0,0,0,9,0,Matches,2018
601,Marek Suchý,cz CZE,DF,Basel,29,1988,8.0,10,8,7,2,1,7,15,46.7,8,8,4,4,26,36,42,1,Matches,2018
602,Niklas Süle,de GER,DF,Bayern Munich,21,1995,7.1,7,6,5,2,0,4,7,57.1,3,11,9,2,11,18,16,0,Matches,2018
603,Marko Šuler,si SVN,DF,NK Maribor,34,1983,5.0,7,4,7,0,0,3,7,42.9,4,8,5,3,10,17,28,2,Matches,2018
604,Mile Svilar,rs SRB,GK,Benfica,17,1999,3.0,0,0,0,0,0,0,0,,0,0,0,0,0,0,4,2,Matches,2018
605,Wojciech Szczęsny,pl POL,GK,Juventus,27,1990,1.0,0,0,0,0,0,0,0,,0,0,0,0,0,0,0,0,Matches,2018
606,Panagiotis Tachtsidis,gr GRE,MF,Olympiacos,26,1991,2.7,7,5,2,5,0,1,6,16.7,5,3,2,1,6,13,4,0,Matches,2018
607,Taison,br BRA,"MF,FW",Shakhtar,29,1988,8.0,6,4,1,1,4,0,9,0.0,9,12,1,11,4,10,3,0,Matches,2018
608,Talisca,br BRA,MF,Beşiktaş,23,1994,6.0,5,4,3,2,0,2,18,11.1,16,7,0,7,5,10,5,0,Matches,2018
609,Renato Tapia,pe PER,DF,Feyenoord,22,1995,3.7,6,4,3,3,0,1,4,25.0,3,5,3,2,6,12,10,1,Matches,2018
610,Serdar Tasci,de GER,DF,Spartak Moscow,30,1987,5.0,7,3,4,3,0,3,5,60.0,2,9,9,0,8,15,17,0,Matches,2018
611,Marcos Tavares,br BRA,FW,NK Maribor,33,1984,5.3,5,2,1,3,1,1,8,12.5,7,4,0,4,1,6,4,1,Matches,2018
612,Alex Telles,br BRA,DF,Porto,24,1992,7.0,12,10,8,2,2,7,14,50.0,7,5,2,3,19,31,17,0,Matches,2018
613,Łukasz Teodorczyk,pl POL,FW,Anderlecht,26,1991,4.3,3,3,0,2,1,0,6,0.0,6,4,1,3,0,3,0,0,Matches,2018
614,Marc-André ter Stegen,de GER,GK,Barcelona,25,1992,9.0,0,0,0,0,0,0,0,,0,0,0,0,0,0,1,1,Matches,2018
615,Youri Tielemans,be BEL,MF,Monaco,20,1997,3.5,9,4,1,8,0,3,7,42.9,4,5,0,5,4,13,3,0,Matches,2018
616,Kieran Tierney,sct SCO,DF,Celtic,20,1997,6.0,11,7,6,5,0,4,10,40.0,6,8,1,7,16,27,19,0,Matches,2018
617,Corentin Tolisso,fr FRA,MF,Bayern Munich,22,1994,5.5,9,4,2,7,0,3,9,33.3,6,8,2,6,3,12,4,1,Matches,2018
618,Jeremy Toljan,de GER,DF,Dortmund,22,1994,3.0,8,6,4,4,0,5,9,55.6,4,5,2,3,4,12,11,0,Matches,2018
619,Jens Toornstra,nl NED,"MF,FW",Feyenoord,28,1989,3.6,5,4,2,3,0,1,7,14.3,6,8,0,8,7,12,4,0,Matches,2018
620,Ömer Toprak,tr TUR,DF,Dortmund,28,1989,3.8,2,1,1,1,0,1,4,25.0,3,2,2,0,6,8,9,0,Matches,2018
621,Fernando Torres,es ESP,FW,Atlético Madrid,33,1984,2.3,2,2,1,1,0,0,3,0.0,3,1,0,1,1,3,1,0,Matches,2018
622,Óliver Torres,es ESP,MF,Porto,22,1994,1.9,6,4,3,1,2,1,6,16.7,5,3,0,3,0,6,4,0,Matches,2018
623,Duško Tošić,rs SRB,DF,Beşiktaş,32,1985,5.6,18,13,11,7,0,9,19,47.4,10,8,4,4,22,40,42,0,Matches,2018
624,Cenk Tosun,tr TUR,FW,Beşiktaş,26,1991,5.0,2,0,0,2,0,2,10,20.0,8,4,1,3,3,5,7,0,Matches,2018
625,Almamy Touré,ml MLI,DF,Monaco,21,1996,3.0,7,4,2,4,1,1,1,100.0,0,2,1,1,3,10,8,0,Matches,2018
626,Yaya Touré,ci CIV,MF,Manchester City,34,1983,2.8,6,2,1,4,1,2,9,22.2,7,2,0,2,1,7,5,0,Matches,2018
627,Adrien Trebel,fr FRA,"MF,DF",Anderlecht,26,1991,6.0,25,19,8,15,2,10,25,40.0,15,9,0,9,18,43,6,3,Matches,2018
628,Kieran Trippier,eng ENG,DF,Tottenham,26,1990,3.0,4,2,1,3,0,2,4,50.0,2,4,0,4,2,6,12,0,Matches,2018
629,Axel Tuanzebe,eng ENG,DF,Manchester Utd,19,1997,0.2,1,1,0,0,1,0,0,,0,0,0,0,1,2,0,0,Matches,2018
630,Sven Ulreich,de GER,GK,Bayern Munich,28,1988,11.0,0,0,0,0,0,0,0,,0,0,0,0,0,0,3,1,Matches,2018
631,Samuel Umtiti,fr FRA,DF,Barcelona,23,1993,9.0,12,7,10,2,0,5,7,71.4,2,9,7,2,20,32,21,1,Matches,2018
632,Cengiz Ünder,tr TUR,"FW,MF",Roma,20,1997,2.6,4,2,1,3,0,2,9,22.2,7,1,0,1,2,6,2,0,Matches,2018
633,Dayot Upamecano,fr FRA,DF,RB Leipzig,18,1998,5.0,15,14,12,2,1,5,9,55.6,4,7,3,4,12,27,36,1,Matches,2018
634,Necip Uysal,tr TUR,DF,Beşiktaş,26,1991,1.9,9,7,6,3,0,4,7,57.1,3,0,0,0,4,13,9,0,Matches,2018
635,Tomáš Vaclík,cz CZE,GK,Basel,28,1989,8.0,0,0,0,0,0,0,0,,0,0,0,0,0,0,6,0,Matches,2018
636,Antonio Valencia,ec ECU,DF,Manchester Utd,31,1985,3.7,7,4,2,4,1,3,4,75.0,1,6,0,6,6,13,19,0,Matches,2018
637,Jesús Vallejo,es ESP,DF,Real Madrid,20,1997,1.0,0,0,0,0,0,0,0,,0,1,1,0,0,0,3,0,Matches,2018
638,Virgil van Dijk,nl NED,DF,Liverpool,26,1991,6.0,5,5,3,1,1,1,2,50.0,1,5,3,2,10,15,42,0,Matches,2018
639,Raphaël Varane,fr FRA,DF,Real Madrid,24,1993,10.4,12,9,10,2,0,8,17,47.1,9,21,13,8,14,26,71,0,Matches,2018
640,Bruno Varela,cv CPV,GK,Benfica,22,1994,2.0,0,0,0,0,0,0,0,,0,0,0,0,0,0,1,0,Matches,2018
641,Viktor Vasin,ru RUS,DF,CSKA Moscow,28,1988,6.0,6,1,6,0,0,4,10,40.0,6,10,5,5,6,12,36,1,Matches,2018
642,Franco Vázquez,ar ARG,MF,Sevilla,28,1989,5.5,10,6,3,5,2,4,15,26.7,11,4,0,4,1,11,5,0,Matches,2018
643,Lucas Vázquez,es ESP,"MF,DF",Real Madrid,26,1991,6.0,17,8,8,9,0,6,16,37.5,10,8,0,8,6,23,12,0,Matches,2018
644,Dylan Vente,nl NED,FW,Feyenoord,18,1999,0.2,0,0,0,0,0,0,0,,0,0,0,0,0,0,0,0,Matches,2018
645,Thomas Vermaelen,be BEL,DF,Barcelona,31,1985,1.0,0,0,0,0,0,0,0,,0,1,0,1,1,1,1,0,Matches,2018
646,Kenneth Vermeer,nl NED,GK,Feyenoord,31,1986,1.0,0,0,0,0,0,0,0,,0,0,0,0,0,0,1,0,Matches,2018
647,Marco Verratti,it ITA,MF,Paris S-G,24,1992,7.1,26,14,11,11,4,14,25,56.0,11,13,4,9,14,40,5,0,Matches,2018
648,Jan Vertonghen,be BEL,DF,Tottenham,30,1987,6.0,14,11,9,4,1,8,12,66.7,4,1,0,1,14,28,25,0,Matches,2018
649,Domagoj Vida,hr CRO,DF,Beşiktaş,28,1989,0.2,0,0,0,0,0,0,0,,0,2,2,0,0,0,3,0,Matches,2018
650,Aleix Vidal,es ESP,"FW,MF",Barcelona,27,1989,1.2,5,4,2,2,1,2,5,40.0,3,0,0,0,5,10,1,0,Matches,2018
651,Arturo Vidal,cl CHI,MF,Bayern Munich,30,1987,5.3,20,14,9,7,4,8,17,47.1,9,8,2,6,10,30,4,0,Matches,2018
652,Luciano Vietto,ar ARG,FW,Atlético Madrid,23,1993,0.8,2,2,0,0,2,1,1,100.0,0,0,0,0,1,3,0,0,Matches,2018
653,Mitja Viler,si SVN,DF,NK Maribor,30,1986,6.0,12,8,7,5,0,10,19,52.6,9,12,6,6,4,16,39,2,Matches,2018
654,Tonny Vilhena,nl NED,MF,Feyenoord,22,1995,5.9,8,5,6,2,0,0,8,0.0,8,5,0,5,8,16,8,1,Matches,2018
655,Vinicius,br BRA,MF,APOEL FC,31,1986,5.2,7,4,3,4,0,4,11,36.4,7,3,0,3,7,14,10,0,Matches,2018
656,Vitinho,br BRA,FW,CSKA Moscow,23,1993,5.2,5,2,3,2,0,2,13,15.4,11,10,1,9,3,8,7,0,Matches,2018
657,Michel Vorm,nl NED,GK,Tottenham,33,1983,1.0,0,0,0,0,0,0,0,,0,0,0,0,0,0,0,0,Matches,2018
658,Praxitelis Vouros,gr GRE,DF,APOEL FC,22,1995,6.0,8,4,4,4,0,3,9,33.3,6,7,1,6,24,32,23,0,Matches,2018
659,Blaž Vrhovec,si SVN,MF,NK Maribor,25,1992,4.4,13,10,6,7,0,4,12,33.3,8,3,3,0,5,18,14,0,Matches,2018
660,Šime Vrsaljko,hr CRO,DF,Atlético Madrid,25,1992,1.0,1,1,1,0,0,0,0,,0,1,1,0,2,3,3,0,Matches,2018
661,Dare Vršič,si SVN,MF,NK Maribor,32,1984,0.6,1,1,1,0,0,0,2,0.0,2,1,0,1,1,2,0,0,Matches,2018
662,Sandro Wagner,de GER,FW,Bayern Munich,29,1987,0.6,2,2,1,1,0,1,1,100.0,0,0,0,0,0,2,2,0,Matches,2018
663,Kyle Walker,eng ENG,DF,Manchester City,27,1990,7.0,8,5,4,3,1,4,8,50.0,4,7,2,5,11,19,19,1,Matches,2018
664,Kyle Walker-Peters,eng ENG,DF,Tottenham,20,1997,0.2,0,0,0,0,0,0,0,,0,0,0,0,0,0,0,0,Matches,2018
665,Victor Wanyama,ke KEN,MF,Tottenham,26,1991,0.0,0,0,0,0,0,0,0,,0,0,0,0,0,0,0,0,Matches,2018
666,Boy Waterman,nl NED,GK,APOEL FC,33,1984,2.5,0,0,0,0,0,0,0,,0,0,0,0,0,0,1,0,Matches,2018
667,Julian Weigl,de GER,MF,Dortmund,21,1995,3.6,13,9,6,6,1,3,10,30.0,7,2,0,2,6,19,7,0,Matches,2018
668,Pontus Wernbloom,se SWE,"MF,FW",CSKA Moscow,31,1986,5.0,8,6,5,2,1,3,10,30.0,7,8,3,5,10,18,10,0,Matches,2018
669,Timo Werner,de GER,FW,RB Leipzig,21,1996,3.7,4,3,2,2,0,2,6,33.3,4,2,1,1,1,5,0,0,Matches,2018
670,Georginio Wijnaldum,nl NED,MF,Liverpool,26,1990,9.4,14,10,5,8,1,6,15,40.0,9,4,0,4,10,24,12,1,Matches,2018
671,Willian,br BRA,"MF,FW",Chelsea,28,1988,4.8,5,3,2,2,1,1,5,20.0,4,5,0,5,1,6,0,0,Matches,2018
672,Harry Winks,eng ENG,MF,Tottenham,21,1996,4.7,6,4,2,3,1,3,9,33.3,6,5,1,4,7,13,5,0,Matches,2018
673,Ricky van Wolfswinkel,nl NED,FW,Basel,28,1989,1.9,2,0,1,1,0,1,1,100.0,0,2,0,2,1,3,2,0,Matches,2018
674,Taulant Xhaka,al ALB,"MF,DF",Basel,26,1991,5.8,13,10,3,10,0,5,11,45.5,6,4,2,2,4,17,12,0,Matches,2018
675,Andriy Yarmolenko,ua UKR,"FW,MF",Dortmund,27,1989,4.2,6,6,0,4,2,1,6,16.7,5,2,0,2,2,8,2,0,Matches,2018
676,Andrey Yeshchenko,ru RUS,DF,Spartak Moscow,33,1984,4.9,17,13,10,6,1,6,17,35.3,11,8,0,8,6,23,27,0,Matches,2018
677,Ashley Young,eng ENG,DF,Manchester Utd,32,1985,3.7,6,4,3,2,1,2,3,66.7,1,5,1,4,9,15,10,0,Matches,2018
678,Elvin Yunuszade,az AZE,"DF,FW",Qarabağ FK,24,1992,1.4,8,7,8,0,0,4,6,66.7,2,2,2,0,2,10,13,0,Matches,2018
679,Dan-Axel Zagadou,fr FRA,DF,Dortmund,18,1999,1.0,1,1,1,0,0,0,1,0.0,1,1,1,0,1,2,4,0,Matches,2018
680,Ghayas Zahid,no NOR,"FW,MF",APOEL FC,22,1994,5.2,3,2,0,2,1,1,10,10.0,9,5,1,4,3,6,4,1,Matches,2018
681,Davide Zappacosta,it ITA,"DF,MF",Chelsea,25,1992,3.9,2,2,1,0,1,1,4,25.0,3,4,0,4,3,5,10,0,Matches,2018
682,Saša Zdjelar,rs SRB,MF,Olympiacos,22,1995,2.3,5,2,3,2,0,1,1,100.0,0,4,1,3,9,14,3,0,Matches,2018
683,Tolga Zengin,tr TUR,GK,Beşiktaş,33,1983,2.0,0,0,0,0,0,0,0,,0,0,0,0,0,0,1,1,Matches,2018
684,Timur Zhamaletdinov,ru RUS,FW,CSKA Moscow,20,1997,1.5,1,1,0,1,0,1,1,100.0,0,2,0,2,0,1,0,0,Matches,2018
685,Piotr Zieliński,pl POL,"MF,FW",Napoli,23,1994,3.9,2,1,1,0,1,0,4,0.0,4,3,0,3,7,9,2,0,Matches,2018
686,Oleksandr Zinchenko,ua UKR,DF,Manchester City,20,1996,1.0,1,1,0,1,0,1,5,20.0,4,0,0,0,1,2,1,1,Matches,2018
687,Andrija Živković,rs SRB,"MF,FW",Benfica,21,1996,3.2,4,3,1,3,0,2,5,40.0,3,6,0,6,1,5,1,0,Matches,2018
688,Roman Zobnin,ru RUS,"DF,FW",Spartak Moscow,23,1994,1.2,1,1,0,0,1,0,1,0.0,1,1,0,1,0,1,0,0,Matches,2018
689,Oleksandr Zubkov,ua UKR,FW,Shakhtar,20,1996,0.0,0,0,0,0,0,0,0,,0,0,0,0,0,0,0,0,Matches,2018
690,Luca Zuffi,ch SUI,MF,Basel,27,1990,7.0,9,6,5,3,1,4,11,36.4,7,5,2,3,10,19,6,0,Matches,2018
691,Uroš Đurđević,me MNE,"FW,MF",Olympiacos,23,1994,2.3,0,0,0,0,0,0,2,0.0,2,2,0,2,1,1,1,0,Matches,2018
692,Bruno Costa,,,Porto,,,1.0,,,,,,,,,,,,,,,,,Matches,2018
